abundance	abundance
accomplished	accomplished
accomplishment	accomplishment
accomplishments	accomplishments
accurate	accurate
adequate	adequate
admirable	admirable
admiration	admiration
admire	admire
adore	adore
advantage	advantage
advocate	advocate
advocates	advocates
affection	affection
affirmative	affirmative
afford	afford
affordable	affordable
amazing	amazing
amazingly	amazingly
ambitious	ambitious
angel	angel
appeal	appeal
appealing	appealing
appreciate	appreciate
appreciated	appreciated
appreciates	appreciates
approval	approval
approve	approve
assure	assure
attraction	attraction
attractive	attractive
authentic	authentic
autonomous	autonomous
available	available
awarded	awarded
awards	awards
awe	awe
awesome	awesome
backbone	backbone
beautiful	beautiful
beautifully	beautifully
beauty	beauty
benefit	benefit
benefits	benefits
best	best
better	better
bless	bless
blessing	blessing
bloom	bloom
bolster	bolster
brave	brave
bravery	bravery
breeze	breeze
brilliant	brilliant
calm	calm
capable	capable
celebrate	celebrate
celebrated	celebrated
celebration	celebration
champion	champion
charismatic	charismatic
chaste	chaste
cheer	cheer
cherish	cherish
clarity	clarity
clean	clean
clear	clear
clearly	clearly
clears	clears
colorful	colorful
comfortable	comfortable
commitment	commitment
compassion	compassion
compassionate	compassionate
complement	complement
complementary	complementary
compliant	compliant
compliment	compliment
comprehensive	comprehensive
concise	concise
confident	confident
congratulate	congratulate
congratulations	congratulations
consistent	consistent
consistently	consistently
contribution	contribution
convenience	convenience
convenient	convenient
convincing	convincing
cool	cool
correct	correct
courage	courage
credible	credible
cure	cure
cushy	cushy
dashing	dashing
dazzle	dazzle
dedicated	dedicated
defeat	defeat
defeated	defeated
delight	delight
desirable	desirable
dignity	dignity
divine	divine
dominated	dominated
eager	eager
easier	easier
easy	easy
educated	educated
effective	effective
elite	elite
empathize	empathize
empower	empower
encourage	encourage
encouraging	encouraging
endorse	endorse
enhances	enhances
enjoy	enjoy
enjoyed	enjoyed
enjoying	enjoying
enjoyment	enjoyment
enough	enough
enraptured	enraptured
entertaining	entertaining
enthusiasm	enthusiasm
envy	envy
ethical	ethical
exalt	exalt
exceeded	exceeded
exceeds	exceeds
excellent	excellent
excited	excited
exciting	exciting
fabulous	fabulous
fair	fair
fairly	fairly
faith	faith
famous	famous
fancy	fancy
fans	fans
fantastic	fantastic
fascinating	fascinating
fascination	fascination
fashionable	fashionable
fast	fast
faster	faster
fav	fav
favor	favor
favorite	favorite
fearless	fearless
fervently	fervently
fiery	fiery
fine	fine
fond	fond
fortunate	fortunate
free	free
freed	freed
freedom	freedom
freedoms	freedoms
fresh	fresh
fun	fun
gain	gain
gained	gained
gaining	gaining
genuine	genuine
glad	glad
gladly	gladly
glorify	glorify
glory	glory
gold	gold
good	good
goodness	goodness
gorgeous	gorgeous
grace	grace
grand	grand
grateful	grateful
great	great
greatest	greatest
greatness	greatness
groundbreaking	groundbreaking
guarantee	guarantee
guidance	guidance
halcyon	halcyon
hallowed	hallowed
happiness	happiness
happy	happy
heal	heal
healthy	healthy
heaven	heaven
helped	helped
helping	helping
hero	hero
high-quality	high-quality
hilarious	hilarious
holy	holy
honest	honest
honesty	honesty
honor	honor
honored	honored
honoring	honoring
hot	hot
hottest	hottest
humble	humble
humor	humor
important	important
impressed	impressed
impressive	impressive
improve	improve
improved	improved
improvements	improvements
incredible	incredible
incredibly	incredibly
inestimable	inestimable
innovation	innovation
inspirational	inspirational
inspire	inspire
inspiring	inspiring
instrumental	instrumental
integral	integral
integrated	integrated
intelligence	intelligence
intelligent	intelligent
interesting	interesting
interests	interests
invincible	invincible
joy	joy
joyfully	joyfully
kindness	kindness
lawful	lawful
lead	lead
leading	leading
leads	leads
led	led
liberty	liberty
likable	likable
like	like
liked	liked
likes	likes
liking	liking
logical	logical
long-lasting	long-lasting
love	love
loved	loved
loves	loves
loving	loving
loyal	loyal
luck	luck
lucky	lucky
magic	magic
mercy	mercy
mighty	mighty
miracle	miracle
miracles	miracles
modern	modern
morality	morality
motivated	motivated
nice	nice
outsmart	outsmart
patience	patience
patient	patient
peace	peace
peaceful	peaceful
perfect	perfect
perfectly	perfectly
perseverance	perseverance
pinnacle	pinnacle
pleasant	pleasant
pleased	pleased
pleases	pleases
pleasing	pleasing
poise	poise
popular	popular
positive	positive
powerful	powerful
praise	praise
praising	praising
precious	precious
precise	precise
prefer	prefer
pretty	pretty
pride	pride
privilege	privilege
privileged	privileged
proficient	proficient
progress	progress
progressive	progressive
prominent	prominent
promise	promise
promised	promised
promises	promises
promising	promising
promoter	promoter
proper	proper
prosper	prosper
prosperity	prosperity
protect	protect
protection	protection
proud	proud
proven	proven
proves	proves
qualified	qualified
quicker	quicker
quiet	quiet
rational	rational
readily	readily
ready	ready
reaffirm	reaffirm
recommend	recommend
recommendation	recommendation
recover	recover
refreshing	refreshing
rejoice	rejoice
renaissance	renaissance
reputation	reputation
respect	respect
respectful	respectful
responsibly	responsibly
revive	revive
rich	rich
richer	richer
right	right
righteous	righteous
righteousness	righteousness
rightful	rightful
safe	safe
sane	sane
satisfied	satisfied
savior	savior
secure	secure
sensible	sensible
sexy	sexy
significant	significant
silent	silent
smart	smart
smarter	smarter
smile	smile
smoothly	smoothly
snazzy	snazzy
soft	soft
solace	solace
solid	solid
stability	stability
stabilize	stabilize
stable	stable
staunch	staunch
strong	strong
stronger	stronger
stunned	stunned
succeed	succeed
success	success
successes	successes
successful	successful
successfully	successfully
super	super
superior	superior
support	support
supported	supported
supporter	supporter
supporting	supporting
supportive	supportive
supports	supports
supreme	supreme
survival	survival
survivor	survivor
sustainable	sustainable
swift	swift
tempt	tempt
thank	thank
thankful	thankful
thrilled	thrilled
thrive	thrive
thriving	thriving
tidy	tidy
top	top
tough	tough
transparent	transparent
trump	trump
trust	trust
trusted	trusted
trusting	trusting
truthful	truthful
unrestricted	unrestricted
valuable	valuable
victory	victory
warm	warm
warmer	warmer
warmth	warmth
wealthy	wealthy
welcome	welcome
well	well
whoa	whoa
willing	willing
win	win
winner	winner
winning	winning
wins	wins
wisdom	wisdom
wise	wise
won	won
wonder	wonder
wonderful	wonderful
wonders	wonders
woo	woo
work	work
worked	worked
works	works
worth	worth
worthy	worthy
wow	wow
yay	yay
zeal	zeal
abolish	abolish
abort	abort
aborted	aborted
absence	absence
absurd	absurd
absurdity	absurdity
abuse	abuse
abused	abused
abysmal	abysmal
accidental	accidental
accusation	accusation
accuse	accuse
accusing	accusing
ache	ache
addicted	addicted
affliction	affliction
afraid	afraid
aggression	aggression
alarming	alarming
anarchy	anarchy
anger	anger
angry	angry
annoyed	annoyed
annoying	annoying
anti-	anti-
anti-social	anti-social
antiquated	antiquated
anxious	anxious
appalling	appalling
archaic	archaic
ashamed	ashamed
assault	assault
attack	attack
attacks	attacks
authoritarian	authoritarian
avenge	avenge
awful	awful
awfully	awfully
awkward	awkward
backward	backward
bad	bad
badly	badly
baffle	baffle
barbaric	barbaric
bash	bash
bashing	bashing
bedlam	bedlam
beg	beg
begging	begging
belittling	belittling
bent	bent
biased	biased
biases	biases
bigotry	bigotry
bitch	bitch
biting	biting
bitterness	bitterness
blame	blame
blatant	blatant
bleed	bleed
blind	blind
bloody	bloody
blow	blow
blur	blur
bogus	bogus
boil	boil
boiling	boiling
bomb	bomb
bondage	bondage
bored	bored
boring	boring
bother	bother
brainless	brainless
break	break
breaking	breaking
breaks	breaks
broke	broke
broken	broken
brutality	brutality
bs	bs
bug	bug
bugs	bugs
bully	bully
bullying	bullying
burn	burn
burned	burned
burning	burning
bust	bust
cancer	cancer
capitulate	capitulate
careless	careless
cataclysmic	cataclysmic
chaos	chaos
chatter	chatter
cheat	cheat
cheats	cheats
chill	chill
choke	choke
chronic	chronic
clueless	clueless
cold	cold
collapse	collapse
collusion	collusion
complain	complain
complained	complained
complaining	complaining
complaints	complaints
complex	complex
conceded	conceded
concern	concern
concerned	concerned
concerns	concerns
concessions	concessions
condemn	condemn
condemns	condemns
confess	confess
conflict	conflict
conflicting	conflicting
conflicts	conflicts
confront	confront
confuse	confuse
conservative	conservative
conspiracy	conspiracy
conspire	conspire
contradiction	contradiction
controversial	controversial
controversy	controversy
corrupt	corrupt
corrupted	corrupted
corruption	corruption
cowardly	cowardly
crap	crap
craziness	craziness
crazy	crazy
crime	crime
criminal	criminal
crisis	crisis
critical	critical
criticize	criticize
criticizing	criticizing
critics	critics
crooks	crooks
cruel	cruel
crush	crush
cry	cry
curses	curses
damage	damage
damn	damn
damnation	damnation
damned	damned
dangerous	dangerous
dark	dark
darkened	darkened
darkness	darkness
dead	dead
deadbeat	deadbeat
deadly	deadly
deaf	deaf
death	death
debacle	debacle
debt	debt
deceit	deceit
deceitful	deceitful
deceptive	deceptive
decline	decline
defiance	defiance
defy	defy
degenerate	degenerate
degradation	degradation
degrade	degrade
dehumanize	dehumanize
deluded	deluded
delusional	delusional
delusions	delusions
denial	denial
denied	denied
denies	denies
deny	deny
depression	depression
deprived	deprived
derogatory	derogatory
desert	desert
desolate	desolate
desperate	desperate
desperately	desperately
desperation	desperation
destroy	destroy
destroyer	destroyer
destruction	destruction
destructive	destructive
deterioration	deterioration
devil	devil
devious	devious
dick	dick
dictator	dictator
die	die
died	died
dies	dies
difficult	difficult
difficulties	difficulties
dire	dire
dirty	dirty
disagree	disagree
disagrees	disagrees
disarm	disarm
disaster	disaster
disastrous	disastrous
discomfort	discomfort
disconcerting	disconcerting
discredit	discredit
discriminate	discriminate
discrimination	discrimination
disgrace	disgrace
disgust	disgust
disgusting	disgusting
disgustingly	disgustingly
dishonest	dishonest
dishonesty	dishonesty
dislike	dislike
disliking	disliking
dismayed	dismayed
disobey	disobey
displaced	displaced
disservice	disservice
dissident	dissident
distorted	distorted
distract	distract
distraction	distraction
distress	distress
disturbing	disturbing
doomed	doomed
doubt	doubt
doubts	doubts
downfall	downfall
drag	drag
drastic	drastic
dread	dread
drunk	drunk
dumb	dumb
dump	dump
dumped	dumped
dumping	dumping
dumps	dumps
dust	dust
dying	dying
effrontery	effrontery
egregious	egregious
embarrass	embarrass
embarrassing	embarrassing
enemies	enemies
enemy	enemy
epidemic	epidemic
erase	erase
err	err
error	error
evil	evil
excuse	excuse
expel	expel
expired	expired
extermination	extermination
extremists	extremists
fail	fail
failed	failed
failing	failing
fake	fake
fall	fall
fallacies	fallacies
fallen	fallen
false	false
falsely	falsely
fanatical	fanatical
fascist	fascist
fat	fat
fatigue	fatigue
fault	fault
fear	fear
fearful	fearful
fears	fears
fell	fell
felon	felon
fib	fib
fictional	fictional
flabbergasted	flabbergasted
flagrant	flagrant
flawed	flawed
flees	flees
fool	fool
forbid	forbid
fragile	fragile
fraud	fraud
frighteningly	frighteningly
froze	froze
frozen	frozen
frustrates	frustrates
frustrating	frustrating
fugitive	fugitive
funny	funny
fuss	fuss
genocide	genocide
gossip	gossip
greed	greed
greedy	greedy
guilt	guilt
guilty	guilty
gullible	gullible
hack	hack
haggle	haggle
hang	hang
hangs	hangs
harass	harass
harassed	harassed
harassment	harassment
hard	hard
harm	harm
harmful	harmful
harsh	harsh
hate	hate
hated	hated
hateful	hateful
hater	hater
haters	haters
hates	hates
hating	hating
hatred	hatred
heck	heck
hedge	hedge
hell	hell
hideous	hideous
hiss	hiss
horrendous	horrendous
horrible	horrible
horrid	horrid
horrific	horrific
hostile	hostile
humid	humid
hurt	hurt
hurting	hurting
hurts	hurts
hypocrisy	hypocrisy
hypocrites	hypocrites
hypocritical	hypocritical
hysterical	hysterical
hysterics	hysterics
idiocy	idiocy
idiot	idiot
idiotic	idiotic
idiots	idiots
ignorance	ignorance
ignorant	ignorant
ignore	ignore
illegal	illegal
illegally	illegally
illness	illness
illusion	illusion
imaginary	imaginary
immoral	immoral
imperfect	imperfect
impossible	impossible
inaccuracies	inaccuracies
inaccurate	inaccurate
incapable	incapable
incompetent	incompetent
inconsequential	inconsequential
indifferent	indifferent
inept	inept
inequality	inequality
inevitable	inevitable
infamous	infamous
inferiority	inferiority
infested	infested
inflated	inflated
inhumanity	inhumanity
injustice	injustice
injustices	injustices
insane	insane
insanity	insanity
insecure	insecure
insecurity	insecurity
insidious	insidious
insult	insult
intimidation	intimidation
invalidate	invalidate
invisible	invisible
irk	irk
ironic	ironic
irony	irony
irrelevant	irrelevant
irreparable	irreparable
issue	issue
issues	issues
jealous	jealous
jerk	jerk
joke	joke
kill	kill
killed	killed
killing	killing
kills	kills
knife	knife
knock	knock
lack	lack
lackey	lackey
lacks	lacks
lawless	lawless
lethal	lethal
liability	liability
liar	liar
liars	liars
lie	lie
lied	lied
lies	lies
limit	limit
limitation	limitation
limitations	limitations
limits	limits
lonely	lonely
loose	loose
lose	lose
loser	loser
losers	losers
loses	loses
losing	losing
loss	loss
lost	lost
loud	loud
louder	louder
lousy	lousy
lunatic	lunatic
lying	lying
mad	mad
manipulate	manipulate
meddle	meddle
mediocre	mediocre
mess	mess
messed	messed
mindless	mindless
mindlessly	mindlessly
mischief	mischief
miserably	miserably
misery	misery
misleading	misleading
miss	miss
missed	missed
mistake	mistake
mistakes	mistakes
misunderstanding	misunderstanding
mock	mock
mocked	mocked
molest	molest
monstrosity	monstrosity
morbidly	morbidly
moron	moron
murder	murder
mystery	mystery
myth	myth
nagging	nagging
naive	naive
nasty	nasty
negative	negative
negatives	negatives
neglect	neglect
negligence	negligence
nightmare	nightmare
nonsense	nonsense
obese	obese
object	object
obscure	obscure
obstructing	obstructing
offend	offend
offending	offending
offensive	offensive
ominous	ominous
onslaught	onslaught
opinionated	opinionated
oppose	oppose
opposition	opposition
oppress	oppress
oppression	oppression
oppressive	oppressive
outrage	outrage
outraged	outraged
outrageously	outrageously
overturn	overturn
overweight	overweight
pain	pain
painful	painful
pale	pale
pander	pander
pandering	pandering
passive	passive
penalty	penalty
persecute	persecute
pervert	pervert
petty	petty
phony	phony
pickets	pickets
pig	pig
pigs	pigs
pity	pity
plight	plight
pointless	pointless
poor	poor
poorly	poorly
posturing	posturing
poverty	poverty
powerless	powerless
predicament	predicament
prejudice	prejudice
premeditated	premeditated
pretend	pretend
prison	prison
problem	problem
problems	problems
propaganda	propaganda
prosecute	prosecute
protest	protest
protesting	protesting
provocative	provocative
puppet	puppet
puzzled	puzzled
quitter	quitter
racism	racism
racist	racist
racists	racists
radical	radical
rage	rage
raging	raging
rampant	rampant
rant	rant
ranting	ranting
rape	rape
raped	raped
raping	raping
rebuke	rebuke
reckless	reckless
refusal	refusal
refuse	refuse
refused	refused
refuses	refuses
refusing	refusing
regret	regret
regrets	regrets
reject	reject
rejected	rejected
rejecting	rejecting
relentless	relentless
repression	repression
repulsive	repulsive
restrictive	restrictive
retarded	retarded
retards	retards
revenge	revenge
revoke	revoke
rhetoric	rhetoric
ridiculous	ridiculous
ripped	ripped
risk	risk
risks	risks
rotten	rotten
ruin	ruin
ruined	ruined
ruining	ruining
ruins	ruins
rumor	rumor
rumors	rumors
sacrificed	sacrificed
sad	sad
savage	savage
scam	scam
scams	scams
scandal	scandal
scandalous	scandalous
scandals	scandals
scar	scar
scare	scare
scared	scared
scary	scary
scream	scream
scum	scum
seething	seething
selfishness	selfishness
setback	setback
setbacks	setbacks
sever	sever
severe	severe
shady	shady
shallow	shallow
shame	shame
shatter	shatter
shit	shit
shock	shock
shocking	shocking
sick	sick
silly	silly
sin	sin
sink	sink
slap	slap
slaughter	slaughter
slaughtered	slaughtered
slave	slave
slow	slow
slut	slut
sluts	sluts
smash	smash
smear	smear
smell	smell
smells	smells
smoke	smoke
snarky	snarky
sorrowful	sorrowful
sorry	sorry
spank	spank
spews	spews
split	split
stall	stall
stalls	stalls
starve	starve
steal	steal
stench	stench
stereotype	stereotype
sticky	sticky
stigma	stigma
stress	stress
struggle	struggle
struggles	struggles
stuck	stuck
stump	stump
stupid	stupid
stupidity	stupidity
subjugate	subjugate
succumb	succumb
suck	suck
sucked	sucked
sucks	sucks
sue	sue
suffer	suffer
suffering	suffering
suicide	suicide
superstition	superstition
superstitious	superstitious
suspect	suspect
tanks	tanks
taunting	taunting
tension	tension
terrible	terrible
terror	terror
terrorism	terrorism
threat	threat
threatening	threatening
tired	tired
tiring	tiring
toll	toll
toughness	toughness
tragedy	tragedy
tragic	tragic
traitor	traitor
trapped	trapped
trash	trash
trauma	trauma
treasonous	treasonous
trouble	trouble
troubles	troubles
tyrant	tyrant
ugly	ugly
unacceptable	unacceptable
unattractive	unattractive
uncomfortable	uncomfortable
undermined	undermined
undignified	undignified
unemployed	unemployed
unequal	unequal
unethical	unethical
unfinished	unfinished
unfit	unfit
unfortunate	unfortunate
unfortunately	unfortunately
unhealthy	unhealthy
unjustified	unjustified
unrealistic	unrealistic
unsure	unsure
untrustworthy	untrustworthy
unwanted	unwanted
unwelcome	unwelcome
unworthy	unworthy
uproar	uproar
upset	upset
upsets	upsets
upsetting	upsetting
urgent	urgent
useless	useless
utterly	utterly
vain	vain
vice	vice
vile	vile
vindictive	vindictive
violent	violent
vulnerable	vulnerable
warned	warned
waste	waste
wasted	wasted
wasting	wasting
wayward	wayward
weak	weak
weakness	weakness
weary	weary
weed	weed
weird	weird
whine	whine
whining	whining
whiny	whiny
wicked	wicked
wildly	wildly
worried	worried
worry	worry
worse	worse
worst	worst
wounds	wounds
wrath	wrath
wretched	wretched
wrong	wrong
