100	100
11	11
2	2
6	6
60	60
70	70
9	9
a	a
able	able
about	about
accept	accept
accessible	accessible
across	across
actual	actual
actually	actually
add	add
additional	additional
address	address
adopted	adopted
advanced	advanced
after	after
again	again
against	against
ages	ages
agree	agree
all	all
almost	almost
already	already
also	also
although	although
always	always
am	am
amazing	amazing
amazon	amazon
america	america
an	an
and	and
annoying	annoying
another	another
answered	answered
any	any
anyone	anyone
anything	anything
applied	applied
appreciate	appreciate
are	are
art	art
as	as
aside	aside
asks	asks
at	at
attacks	attacks
attempt	attempt
author	author
authority	authority
avid	avid
awesome	awesome
awful	awful
back	back
bad	bad
badly	badly
barely	barely
based	based
basic	basic
basically	basically
basics	basics
be	be
beautiful	beautiful
beautifully	beautifully
because	because
become	become
been	been
began	began
begin	begin
beginners	beginners
begins	begins
being	being
believe	believe
benefit	benefit
benefits	benefits
best	best
bet	bet
better	better
biased	biased
big	big
blame	blame
book	book
books	books
boring	boring
bother	bother
bought	bought
breaking	breaking
breath	breath
brings	brings
brown	brown
brutal	brutal
business	business
but	but
buy	buy
buying	buying
by	by
c	c
call	call
calling	calling
campaign	campaign
can	can
care	care
carl	carl
case	case
cell	cell
challenges	challenges
changed	changed
changes	changes
chapter	chapter
character	character
china	china
christian	christian
christianity	christianity
christians	christians
circle	circle
claim	claim
claims	claims
clients	clients
com	com
comes	comes
companion	companion
compare	compare
completely	completely
comprehensive	comprehensive
conclusion	conclusion
conclusions	conclusions
consumers	consumers
continually	continually
cookbook	cookbook
cool	cool
copies	copies
core	core
correct	correct
could	could
countries	countries
cover	cover
covered	covered
covers	covers
creatures	creatures
cut	cut
danielle	danielle
date	date
daughter	daughter
day	day
decent	decent
defense	defense
definition	definition
describe	describe
deserve	deserve
detailed	detailed
development	development
develops	develops
devoted	devoted
dialog	dialog
did	did
didn	didn
different	different
difficult	difficult
disappoint	disappoint
disappointed	disappointed
disappointing	disappointing
disappointment	disappointment
discusses	discusses
do	do
doesn	doesn
don	don
done	done
down	down
dramatic	dramatic
dreams	dreams
dull	dull
dumb	dumb
each	each
easy	easy
editor	editor
effort	effort
efforts	efforts
ego	ego
either	either
elsewhere	elsewhere
end	end
ended	ended
endless	endless
engaging	engaging
enjoy	enjoy
enjoyable	enjoyable
enjoyed	enjoyed
enough	enough
entertaining	entertaining
errors	errors
especially	especially
essentially	essentially
even	even
events	events
every	every
everyone	everyone
everywhere	everywhere
examines	examines
example	example
excellent	excellent
exercises	exercises
exist	exist
existence	existence
expect	expect
expected	expected
expecting	expecting
experience	experience
explains	explains
explores	explores
extra	extra
extraordinary	extraordinary
extreme	extreme
fabulous	fabulous
failed	failed
fails	fails
failures	failures
familiar	familiar
family	family
famous	famous
fan	fan
fantastic	fantastic
far	far
fascinating	fascinating
fast	fast
father	father
fault	fault
favorite	favorite
favorites	favorites
felt	felt
few	few
figures	figures
find	find
finest	finest
finish	finish
first	first
flat	flat
focuses	focuses
folks	folks
food	food
for	for
forever	forever
found	found
friend	friend
friendly	friendly
friendship	friendship
from	from
fun	fun
furthermore	furthermore
gave	gave
gem	gem
get	get
gets	gets
gift	gift
gifted	gifted
give	give
given	given
gives	gives
glimpse	glimpse
go	go
going	going
good	good
gorgeous	gorgeous
got	got
gotten	gotten
grace	grace
grateful	grateful
great	great
ground	ground
guess	guess
guy	guy
habits	habits
had	had
half	half
halfway	halfway
hand	hand
handy	handy
happens	happens
hard	hard
hardly	hardly
harvard	harvard
has	has
hate	hate
hatred	hatred
have	have
he	he
heart	heart
heavy	heavy
help	help
helped	helped
helps	helps
her	her
highly	highly
hilarious	hilarious
himself	himself
his	his
historians	historians
historical	historical
histories	histories
history	history
holocaust	holocaust
home	home
honest	honest
honestly	honestly
hoping	hoping
horrible	horrible
horse	horse
hospital	hospital
house	house
how	how
however	however
humor	humor
i	i
idea	idea
ideas	ideas
if	if
ignored	ignored
illustrated	illustrated
illustrations	illustrations
importance	importance
important	important
impossible	impossible
impression	impression
in	in
includes	includes
including	including
insightful	insightful
instead	instead
interested	interested
interesting	interesting
internet	internet
intrigue	intrigue
invaluable	invaluable
investigation	investigation
involved	involved
is	is
isn	isn
it	it
its	its
jesus	jesus
job	job
journey	journey
joy	joy
just	just
keep	keep
keeps	keeps
kept	kept
kind	kind
know	know
knowledge	knowledge
known	known
lack	lack
lacks	lacks
latest	latest
learned	learned
learning	learning
leave	leave
left	left
lesson	lesson
lessons	lessons
let	let
level	level
lie	lie
life	life
like	like
literally	literally
little	little
live	live
ll	ll
logic	logic
long	long
looked	looked
lot	lot
love	love
loved	loved
loves	loves
lying	lying
m	m
mainstream	mainstream
make	make
makes	makes
man	man
manager	manager
managers	managers
managing	managing
many	many
master	master
masterpiece	masterpiece
matter	matter
may	may
maybe	maybe
me	me
mean	mean
meanwhile	meanwhile
members	members
mention	mention
mentions	mentions
mere	mere
mexico	mexico
middle	middle
might	might
mind	mind
mistake	mistake
mistakes	mistakes
moment	moment
money	money
more	more
most	most
mr	mr
much	much
must	must
my	my
myths	myths
name	name
named	named
narrow	narrow
national	national
nature	nature
nearly	nearly
neighbors	neighbors
neither	neither
net	net
never	never
new	new
no	no
none	none
nor	nor
not	not
nothing	nothing
notice	notice
noticed	noticed
novels	novels
numbers	numbers
observation	observation
obvious	obvious
of	of
off	off
ok	ok
okay	okay
old	old
older	older
on	on
once	once
one	one
online	online
only	only
opposite	opposite
or	or
other	other
our	our
out	out
outside	outside
outstanding	outstanding
own	own
p	p
pace	pace
paced	paced
page	page
pages	pages
paper	paper
paperback	paperback
paragraph	paragraph
part	part
pass	pass
passion	passion
pay	pay
people	people
performance	performance
perhaps	perhaps
person	person
personal	personal
personally	personally
perspective	perspective
photography	photography
physical	physical
pick	pick
picked	picked
pieces	pieces
place	place
plans	plans
please	please
plot	plot
point	point
politics	politics
poor	poor
poorly	poorly
powerful	powerful
practical	practical
predictable	predictable
premise	premise
presenting	presenting
principles	principles
printing	printing
probably	probably
process	process
profound	profound
propaganda	propaganda
provided	provided
provides	provides
publisher	publisher
pull	pull
pursue	pursue
put	put
putting	putting
quite	quite
quot	quot
racist	racist
rare	rare
rather	rather
raw	raw
re	re
reaction	reaction
read	read
readable	readable
reader	reader
readers	readers
reading	reading
reads	reads
real	real
reality	reality
really	really
reason	reason
recipes	recipes
recognize	recognize
recommend	recommend
recommended	recommended
release	release
relevant	relevant
remarkable	remarkable
repetitive	repetitive
required	required
rest	rest
revealing	revealing
review	review
reviews	reviews
ridiculous	ridiculous
running	running
s	s
sad	sad
sadly	sadly
said	said
sale	sale
same	same
save	save
saw	saw
say	say
saying	saying
says	says
searching	searching
see	see
seeking	seeking
seem	seem
seems	seems
self	self
sense	sense
sensitive	sensitive
seriously	seriously
set	set
several	several
shallow	shallow
shame	shame
share	share
shared	shared
shares	shares
she	she
should	should
showing	showing
shows	shows
significance	significance
silly	silly
simple	simple
skip	skip
sleep	sleep
slow	slow
so	so
social	social
solid	solid
solved	solved
some	some
someone	someone
son	son
soon	soon
sorry	sorry
sort	sort
south	south
speak	speak
special	special
spends	spends
stand	stand
stars	stars
starting	starting
starts	starts
status	status
steel	steel
step	step
steve	steve
stick	stick
still	still
stories	stories
story	story
storyline	storyline
straight	straight
strategic	strategic
strategy	strategy
strong	strong
stronger	stronger
studied	studied
studies	studies
stunning	stunning
stupid	stupid
styles	styles
subsequent	subsequent
substance	substance
sue	sue
super	super
supposed	supposed
supposedly	supposedly
sure	sure
surprises	surprises
suspect	suspect
t	t
take	take
task	task
techniques	techniques
tedious	tedious
tell	tell
term	term
terrible	terrible
terrific	terrific
territory	territory
text	text
textbook	textbook
than	than
that	that
the	the
their	their
them	them
then	then
there	there
these	these
they	they
thin	thin
thing	thing
think	think
this	this
those	those
thought	thought
thousands	thousands
through	through
throw	throw
time	time
tired	tired
title	title
to	to
together	together
tone	tone
too	too
totally	totally
touching	touching
town	town
tradition	tradition
treat	treat
trying	trying
turner	turner
turns	turns
twists	twists
two	two
unbelievable	unbelievable
understand	understand
unfortunately	unfortunately
universal	universal
unless	unless
up	up
used	used
useful	useful
useless	useless
valuable	valuable
variety	variety
ve	ve
very	very
vietnam	vietnam
view	view
vivid	vivid
want	want
wanted	wanted
was	was
washington	washington
waste	waste
wasted	wasted
way	way
ways	ways
we	we
weak	weak
weather	weather
website	website
well	well
went	went
were	were
western	western
what	what
whatever	whatever
when	when
where	where
whether	whether
which	which
while	while
who	who
whole	whole
whose	whose
why	why
wide	wide
will	will
winter	winter
wish	wish
with	with
wolf	wolf
women	women
wonder	wonder
wonderful	wonderful
wondering	wondering
words	words
work	work
works	works
world	world
worse	worse
worst	worst
worth	worth
would	would
wouldn	wouldn
writer	writer
writing	writing
written	written
wrong	wrong
year	year
years	years
you	you
your	your
