100	100
11	11
13	13
2	2
60	60
70	70
80	80
9	9
a	a
ability	ability
able	able
about	about
absorbing	absorbing
accept	accept
accessible	accessible
achieve	achieve
actual	actual
actually	actually
adapt	adapt
add	add
addition	addition
address	address
adds	adds
admit	admit
admitted	admitted
adopted	adopted
advanced	advanced
affects	affects
after	after
again	again
agenda	agenda
agree	agree
all	all
almost	almost
already	already
also	also
always	always
am	am
amazing	amazing
amazon	amazon
america	america
an	an
and	and
ann	ann
anna	anna
annoying	annoying
another	another
answered	answered
anti	anti
any	any
anyone	anyone
anything	anything
anyway	anyway
apparently	apparently
appears	appears
application	application
applied	applied
appreciate	appreciate
appreciated	appreciated
are	are
army	army
around	around
art	art
as	as
aside	aside
asks	asks
at	at
attempt	attempt
attracted	attracted
author	author
authority	authority
available	available
avid	avid
awe	awe
awesome	awesome
awful	awful
b	b
back	back
bad	bad
badly	badly
barely	barely
basic	basic
basically	basically
basics	basics
be	be
beautiful	beautiful
beautifully	beautifully
beauty	beauty
because	because
become	become
becomes	becomes
been	been
began	began
begin	begin
beginner	beginner
beginners	beginners
begins	begins
being	being
believe	believe
believer	believer
benefit	benefit
benefits	benefits
best	best
bet	bet
better	better
biased	biased
big	big
birth	birth
blame	blame
blessing	blessing
blind	blind
blood	blood
blown	blown
bond	bond
book	book
books	books
bore	bore
boring	boring
borrow	borrow
both	both
bother	bother
bothered	bothered
bought	bought
breath	breath
brings	brings
broken	broken
brothers	brothers
brown	brown
bull	bull
but	but
buy	buy
buying	buying
by	by
c	c
call	call
calling	calling
campaign	campaign
can	can
cards	cards
care	care
career	career
carl	carl
cars	cars
case	case
century	century
challenges	challenges
changed	changed
changes	changes
chapter	chapter
character	character
characters	characters
check	check
china	china
circle	circle
claim	claim
claims	claims
classroom	classroom
cliche	cliche
closed	closed
com	com
come	come
comes	comes
commonly	commonly
compare	compare
completely	completely
comprehensive	comprehensive
concepts	concepts
conclude	conclude
conclusion	conclusion
conclusions	conclusions
conduct	conduct
confusing	confusing
connection	connection
conservative	conservative
consider	consider
contains	contains
context	context
continually	continually
continues	continues
contributions	contributions
contrived	contrived
copies	copies
core	core
correct	correct
correctly	correctly
could	could
countries	countries
country	country
courage	courage
cover	cover
covers	covers
creatures	creatures
credible	credible
crimes	crimes
cut	cut
d	d
date	date
day	day
decent	decent
decisions	decisions
deep	deep
deeply	deeply
definitely	definitely
delightful	delightful
description	description
detailed	detailed
determination	determination
determined	determined
developing	developing
development	development
develops	develops
devoted	devoted
dialog	dialog
dialogue	dialogue
did	did
didn	didn
difficult	difficult
disappoint	disappoint
disappointed	disappointed
disappointing	disappointing
disappointment	disappointment
discipline	discipline
disgusting	disgusting
do	do
does	does
doesn	doesn
dogs	dogs
don	don
doubt	doubt
draft	draft
dramatic	dramatic
draw	draw
drawn	drawn
dreams	dreams
drink	drink
driving	driving
drop	drop
drug	drug
dull	dull
during	during
e	e
each	each
early	early
earth	earth
easily	easily
easy	easy
editing	editing
editor	editor
educational	educational
edward	edward
effort	effort
either	either
else	else
elsewhere	elsewhere
end	end
ending	ending
endless	endless
engaging	engaging
english	english
enjoy	enjoy
enjoyable	enjoyable
enjoyed	enjoyed
enough	enough
entertaining	entertaining
entertainment	entertainment
entire	entire
entries	entries
equipment	equipment
errors	errors
especially	especially
essential	essential
etc	etc
even	even
events	events
every	every
everywhere	everywhere
example	example
excellent	excellent
exercises	exercises
exist	exist
existed	existed
existence	existence
expanding	expanding
expectations	expectations
expected	expected
expecting	expecting
experience	experience
experienced	experienced
experiences	experiences
explained	explained
explains	explains
exploration	exploration
explores	explores
extra	extra
extraordinary	extraordinary
extreme	extreme
fabulous	fabulous
failed	failed
fails	fails
failures	failures
fairly	fairly
false	false
familiar	familiar
family	family
famous	famous
fan	fan
fantastic	fantastic
far	far
fascinating	fascinating
fast	fast
father	father
fault	fault
faults	faults
favorite	favorite
favorites	favorites
feel	feel
felt	felt
few	few
fiction	fiction
figures	figures
film	film
find	find
finish	finish
first	first
flat	flat
flavor	flavor
fluff	fluff
focuses	focuses
for	for
form	form
forward	forward
found	found
four	four
frankly	frankly
free	free
frequently	frequently
friend	friend
friendship	friendship
from	from
frustrated	frustrated
frustrating	frustrating
fun	fun
games	games
garbage	garbage
gave	gave
get	get
gets	gets
gift	gift
give	give
gives	gives
giving	giving
glad	glad
glimpse	glimpse
go	go
goal	goal
god	god
going	going
good	good
got	got
gotten	gotten
grace	grace
great	great
ground	ground
grows	grows
guess	guess
guy	guy
guys	guys
had	had
half	half
halfway	halfway
hand	hand
happen	happen
happens	happens
happily	happily
hard	hard
hardly	hardly
has	has
hate	hate
hatred	hatred
have	have
he	he
heart	heart
heavy	heavy
hell	hell
help	help
helped	helped
helps	helps
henry	henry
her	her
here	here
herself	herself
hey	hey
highly	highly
him	him
his	his
historians	historians
history	history
hit	hit
holocaust	holocaust
home	home
honestly	honestly
hoping	hoping
horrible	horrible
horror	horror
house	house
how	how
however	however
huge	huge
human	human
humor	humor
i	i
idea	idea
ideas	ideas
if	if
illuminating	illuminating
illustrated	illustrated
imagery	imagery
images	images
imagination	imagination
importance	importance
important	important
impossible	impossible
impression	impression
improved	improved
improvement	improvement
improving	improving
in	in
included	included
includes	includes
including	including
indulgent	indulgent
info	info
inside	inside
insightful	insightful
instead	instead
instructions	instructions
interested	interested
interesting	interesting
internal	internal
internet	internet
into	into
intrigue	intrigue
invaluable	invaluable
investigation	investigation
involved	involved
ironically	ironically
irritating	irritating
is	is
it	it
its	its
january	january
jews	jews
job	job
joke	joke
journey	journey
joy	joy
joyce	joyce
just	just
justify	justify
keep	keep
keeps	keeps
kept	kept
key	key
kids	kids
kind	kind
know	know
knowledge	knowledge
known	known
knows	knows
lack	lack
lacking	lacking
lacks	lacks
land	land
language	language
latest	latest
learn	learn
learned	learned
learning	learning
leave	leave
led	led
lee	lee
left	left
less	less
lesson	lesson
lessons	lessons
let	let
lie	lie
life	life
like	like
listened	listened
little	little
lives	lives
ll	ll
long	long
look	look
looking	looking
looks	looks
louis	louis
love	love
loved	loved
lying	lying
m	m
made	made
magnificent	magnificent
mainstream	mainstream
make	make
makes	makes
man	man
manager	manager
managing	managing
manual	manual
many	many
marvelous	marvelous
master	master
masterpiece	masterpiece
material	material
matter	matter
may	may
maybe	maybe
me	me
mean	mean
means	means
mediocre	mediocre
meet	meet
mention	mention
mentions	mentions
methods	methods
middle	middle
might	might
miller	miller
million	million
millions	millions
mind	mind
misleading	misleading
miss	miss
missing	missing
mistake	mistake
moment	moment
money	money
more	more
most	most
mountains	mountains
movements	movements
mr	mr
much	much
murder	murder
must	must
my	my
mysteries	mysteries
mysterious	mysterious
name	name
named	named
narrow	narrow
national	national
native	native
nature	nature
near	near
nearly	nearly
need	need
neither	neither
never	never
new	new
no	no
none	none
nor	nor
not	not
nothing	nothing
notice	notice
now	now
numbers	numbers
obvious	obvious
occasionally	occasionally
of	of
off	off
oh	oh
ok	ok
okay	okay
old	old
older	older
on	on
once	once
one	one
online	online
only	only
open	open
or	or
other	other
others	others
our	our
out	out
outstanding	outstanding
own	own
pace	pace
paced	paced
pages	pages
paid	paid
painful	painful
painfully	painfully
paragraph	paragraph
paragraphs	paragraphs
part	part
particular	particular
pass	pass
past	past
pathetic	pathetic
pay	pay
people	people
performance	performance
perhaps	perhaps
period	period
person	person
personal	personal
personally	personally
perspective	perspective
photo	photo
phrases	phrases
physical	physical
pick	pick
picked	picked
places	places
plane	plane
plans	plans
play	play
players	players
pleasant	pleasant
please	please
pleasure	pleasure
plenty	plenty
plot	plot
poignant	poignant
point	point
pointed	pointed
police	police
political	political
politicians	politicians
politics	politics
poor	poor
poorly	poorly
powerful	powerful
practical	practical
predictable	predictable
prefer	prefer
premise	premise
prepared	prepared
presents	presents
pressure	pressure
pretty	pretty
price	price
principles	principles
probably	probably
problems	problems
process	process
production	production
professionals	professionals
profound	profound
promote	promote
protagonists	protagonists
proved	proved
provided	provided
provides	provides
provoking	provoking
psychological	psychological
purchased	purchased
pursuit	pursuit
put	put
putting	putting
quit	quit
quot	quot
racist	racist
rare	rare
rate	rate
rated	rated
rather	rather
re	re
reaction	reaction
read	read
reading	reading
real	real
realized	realized
really	really
reason	reason
reasonable	reasonable
recommend	recommend
recommended	recommended
redundant	redundant
regardless	regardless
release	release
relevant	relevant
remain	remain
remarkable	remarkable
repetitive	repetitive
required	required
resource	resource
responsible	responsible
resulted	resulted
return	return
reveal	reveal
revealing	revealing
review	review
reviewer	reviewer
reviews	reviews
rich	rich
ridiculous	ridiculous
rise	rise
rising	rising
running	running
russia	russia
s	s
sad	sad
sadly	sadly
said	said
same	same
sat	sat
save	save
say	say
saying	saying
says	says
scene	scene
see	see
seeking	seeking
seem	seem
seemed	seemed
seemingly	seemingly
seems	seems
seen	seen
self	self
senior	senior
sense	sense
sensitive	sensitive
sentence	sentence
serious	serious
seriously	seriously
several	several
sex	sex
shallow	shallow
share	share
shares	shares
she	she
shot	shot
should	should
showing	showing
shows	shows
significance	significance
silly	silly
simple	simple
since	since
skip	skip
skipping	skipping
sleep	sleep
slow	slow
small	small
smith	smith
so	so
social	social
solid	solid
solved	solved
some	some
someone	someone
something	something
son	son
soon	soon
sorry	sorry
sort	sort
sounded	sounded
source	source
south	south
speak	speak
special	special
spend	spend
spends	spends
spirit	spirit
split	split
star	star
stars	stars
started	started
starting	starting
starts	starts
states	states
status	status
steel	steel
step	step
stephen	stephen
steps	steps
stick	stick
still	still
storm	storm
story	story
storyline	storyline
straight	straight
strategic	strategic
strike	strike
strong	strong
studying	studying
stunning	stunning
stupid	stupid
style	style
subsequent	subsequent
substance	substance
superficial	superficial
support	support
suppose	suppose
supposed	supposed
supposedly	supposedly
sure	sure
surprise	surprise
suspect	suspect
t	t
take	take
taking	taking
teaches	teaches
tedious	tedious
tell	tell
terrific	terrific
testament	testament
text	text
than	than
that	that
the	the
their	their
them	them
theme	theme
then	then
therapy	therapy
there	there
they	they
thin	thin
thing	thing
things	things
think	think
thinks	thinks
this	this
thorough	thorough
those	those
thought	thought
thousands	thousands
through	through
tidbits	tidbits
time	time
times	times
tired	tired
title	title
to	to
today	today
together	together
tone	tone
too	too
totally	totally
touch	touch
touches	touches
touching	touching
town	town
track	track
tradition	tradition
traditional	traditional
treat	treat
tremendous	tremendous
tried	tried
true	true
truly	truly
trying	trying
turner	turner
turns	turns
twentieth	twentieth
twice	twice
two	two
unbelievable	unbelievable
understand	understand
unfortunately	unfortunately
unless	unless
unrealistic	unrealistic
up	up
us	us
used	used
useful	useful
useless	useless
usually	usually
vague	vague
valuable	valuable
variety	variety
vast	vast
ve	ve
very	very
views	views
visual	visual
vivid	vivid
voice	voice
w	w
want	want
wanted	wanted
warning	warning
was	was
washington	washington
wasn	wasn
waste	waste
wasted	wasted
way	way
ways	ways
we	we
weak	weak
wealth	wealth
wealthy	wealthy
wearing	wearing
weather	weather
website	website
well	well
went	went
were	were
weren	weren
western	western
what	what
whatever	whatever
whatsoever	whatsoever
when	when
where	where
whether	whether
which	which
while	while
who	who
whole	whole
why	why
wide	wide
will	will
winter	winter
wisdom	wisdom
wish	wish
with	with
wolf	wolf
women	women
wonder	wonder
wonderful	wonderful
words	words
work	work
workers	workers
works	works
world	world
worse	worse
worst	worst
worth	worth
would	would
wouldn	wouldn
write	write
writer	writer
writing	writing
written	written
wrong	wrong
wrote	wrote
www	www
x	x
year	year
years	years
york	york
you	you
your	your
yourself	yourself
zero	zero
