1	1
10	10
18	18
2	2
20	20
3	3
30	30
4	4
5	5
50	50
7	7
a	a
ability	ability
able	able
about	about
above	above
absolutely	absolutely
absurd	absurd
academy	academy
act	act
acted	acted
acting	acting
action	action
actors	actors
actual	actual
add	add
added	added
adding	adding
addition	addition
adore	adore
advanced	advanced
adventure	adventure
advise	advise
affair	affair
after	after
again	again
against	against
age	age
ahead	ahead
aimed	aimed
alfred	alfred
all	all
allows	allows
almost	almost
along	along
alot	alot
also	also
although	although
always	always
am	am
amazing	amazing
amazingly	amazingly
america	america
among	among
an	an
ana	ana
and	and
andy	andy
animal	animal
animals	animals
anniversary	anniversary
annoying	annoying
anonymous	anonymous
another	another
any	any
anyone	anyone
apparent	apparent
appeared	appeared
appreciate	appreciate
appreciation	appreciation
approach	approach
are	are
area	area
aren	aren
army	army
around	around
arrested	arrested
arrives	arrives
art	art
as	as
ashamed	ashamed
aside	aside
asking	asking
asleep	asleep
at	at
atrocious	atrocious
attempt	attempt
attempted	attempted
attempts	attempts
audience	audience
austin	austin
available	available
avoid	avoid
aware	aware
away	away
awesome	awesome
awful	awful
awkward	awkward
b	b
back	back
background	background
bad	bad
band	band
bang	bang
barely	barely
based	based
basically	basically
battle	battle
be	be
beautiful	beautiful
beautifully	beautifully
beauty	beauty
because	because
become	become
becomes	becomes
becoming	becoming
been	been
before	before
begins	begins
behind	behind
being	being
believe	believe
best	best
betrayal	betrayal
better	better
between	between
bigger	bigger
bill	bill
bit	bit
blah	blah
bland	bland
bonus	bonus
book	book
boot	boot
bore	bore
bored	bored
boring	boring
both	both
bother	bother
bought	bought
brian	brian
brilliant	brilliant
brilliantly	brilliantly
broadway	broadway
broken	broken
bros	bros
brought	brought
bruce	bruce
bucks	bucks
buddies	buddies
budget	budget
bunch	bunch
burned	burned
business	business
but	but
butt	butt
button	button
buy	buy
buying	buying
by	by
call	call
called	called
came	came
can	can
captures	captures
cardio	cardio
care	care
carefully	carefully
carry	carry
cast	cast
caught	caught
cause	cause
certainly	certainly
changes	changes
character	character
characters	characters
cheap	cheap
cheaper	cheaper
cheesy	cheesy
chemistry	chemistry
chicago	chicago
childhood	childhood
childish	childish
children	children
chose	chose
chosen	chosen
christmas	christmas
cinderella	cinderella
city	city
classic	classic
clich	clich
cliches	cliches
close	close
club	club
co	co
cold	cold
collection	collection
colorful	colorful
combination	combination
combined	combined
combines	combines
come	come
comedy	comedy
comical	comical
coming	coming
comment	comment
commentary	commentary
commit	commit
complaint	complaint
complete	complete
completely	completely
concept	concept
confused	confused
confusing	confusing
consequences	consequences
considering	considering
contains	contains
contemporary	contemporary
continues	continues
contrived	contrived
cool	cool
core	core
could	could
couldn	couldn
couple	couple
courage	courage
course	course
cover	cover
crap	crap
crappy	crappy
created	created
creepy	creepy
crimes	crimes
cry	cry
cut	cut
d	d
damn	damn
damned	damned
dance	dance
dark	dark
daughter	daughter
day	day
de	de
deal	deal
death	death
deep	deep
definitely	definitely
delight	delight
delightful	delightful
delivered	delivered
demands	demands
denise	denise
deny	deny
depicts	depicts
desperate	desperate
destroyed	destroyed
development	development
dialog	dialog
dialogue	dialogue
did	did
didn	didn
different	different
difficult	difficult
difficulties	difficulties
difficulty	difficulty
digital	digital
director	director
disappointed	disappointed
disappointing	disappointing
disappointment	disappointment
disgusting	disgusting
dissapointment	dissapointment
do	do
doc	doc
documentary	documentary
does	does
doesn	doesn
doesnt	doesnt
dogs	dogs
doing	doing
don	don
done	done
down	down
dr	dr
draw	draw
drawn	drawn
drive	drive
drivel	drivel
dull	dull
dumb	dumb
duty	duty
dvd	dvd
dvds	dvds
each	each
ed	ed
edge	edge
editing	editing
edition	edition
effect	effect
effectively	effectively
effort	effort
either	either
else	else
em	em
embarrassing	embarrassing
empty	empty
endless	endless
enemy	enemy
engaged	engaged
english	english
enhanced	enhanced
enjoy	enjoy
enjoyable	enjoyable
enjoyed	enjoyed
enjoys	enjoys
enough	enough
ensemble	ensemble
entertaining	entertaining
episode	episode
episodes	episodes
especially	especially
essential	essential
et	et
european	european
eve	eve
even	even
event	event
events	events
ever	ever
every	every
everybody	everybody
everyone	everyone
everything	everything
exactly	exactly
excellent	excellent
except	except
exceptional	exceptional
excited	excited
excuse	excuse
exercises	exercises
existed	existed
existential	existential
expected	expected
expensive	expensive
explain	explain
explanation	explanation
extended	extended
extras	extras
fabulous	fabulous
face	face
fact	fact
failed	failed
fails	fails
failure	failure
fair	fair
fake	fake
fall	fall
falls	falls
familiar	familiar
family	family
fantastic	fantastic
fascinating	fascinating
fast	fast
fatal	fatal
father	father
fault	fault
favor	favor
favorite	favorite
favorites	favorites
fbi	fbi
feast	feast
feature	feature
featured	featured
features	features
featurette	featurette
fell	fell
felt	felt
few	few
fight	fight
fighting	fighting
fights	fights
figure	figure
figures	figures
files	files
filled	filled
film	film
films	films
finale	finale
finally	finally
find	find
finds	finds
fine	fine
finest	finest
first	first
fits	fits
five	five
flat	flat
flaw	flaw
focus	focus
footage	footage
for	for
forces	forces
forcing	forcing
ford	ford
forgotten	forgotten
found	found
four	four
frame	frame
fresh	fresh
friendship	friendship
from	from
front	front
fully	fully
fun	fun
funny	funny
game	game
games	games
gangster	gangster
garbage	garbage
gave	gave
gay	gay
gem	gem
generation	generation
genius	genius
get	get
gets	gets
getting	getting
girl	girl
give	give
gives	gives
glass	glass
glory	glory
glued	glued
go	go
goal	goal
goes	goes
going	going
gold	gold
good	good
gorgeous	gorgeous
got	got
gotten	gotten
grace	grace
graduate	graduate
great	great
greatest	greatest
grew	grew
grossly	grossly
ground	ground
group	group
guessing	guessing
guy	guy
had	had
half	half
halfway	halfway
hall	hall
handed	handed
hands	hands
happening	happening
happy	happy
hard	hard
harris	harris
harrison	harrison
has	has
hate	hate
hated	hated
have	have
haven	haven
having	having
hayden	hayden
he	he
head	head
health	health
hearing	hearing
heart	heart
hearts	hearts
heartwarming	heartwarming
hell	hell
her	her
here	here
highly	highly
hilarious	hilarious
him	him
his	his
historian	historian
hit	hit
hitler	hitler
home	home
honest	honest
hooked	hooked
hope	hope
hoping	hoping
horrendous	horrendous
horrible	horrible
horrid	horrid
hour	hour
hours	hours
how	how
however	however
huge	huge
huh	huh
humanity	humanity
humorous	humorous
hunt	hunt
husband	husband
i	i
idiotic	idiotic
if	if
image	image
impressive	impressive
in	in
inane	inane
included	included
includes	includes
including	including
incredible	incredible
incredibly	incredibly
inevitable	inevitable
insight	insight
insipid	insipid
instead	instead
intact	intact
intense	intense
interesting	interesting
interpretation	interpretation
interview	interview
interviews	interviews
into	into
introduced	introduced
introduces	introduces
introduction	introduction
is	is
issues	issues
it	it
items	items
its	its
j	j
jack	jack
jackson	jackson
james	james
job	job
john	john
joke	joke
jokes	jokes
julia	julia
jump	jump
junk	junk
just	just
juvenile	juvenile
kidding	kidding
killer	killer
kind	kind
know	know
knowing	knowing
lab	lab
lack	lack
lacking	lacking
lacks	lacks
lame	lame
last	last
later	later
laugh	laugh
laughable	laughable
laughs	laughs
law	law
learn	learn
learned	learned
learns	learns
least	least
leave	leave
legitimate	legitimate
leonard	leonard
less	less
let	let
letting	letting
levels	levels
liberal	liberal
life	life
like	like
likes	likes
little	little
ll	ll
load	load
look	look
looked	looked
looks	looks
lot	lot
love	love
loved	loved
lovers	lovers
loves	loves
low	low
lyrics	lyrics
magical	magical
magnificent	magnificent
main	main
major	major
make	make
makes	makes
making	making
man	man
many	many
maria	maria
mario	mario
married	married
marry	marry
martin	martin
marvelous	marvelous
masterful	masterful
masterpiece	masterpiece
may	may
maybe	maybe
me	me
mean	mean
means	means
meant	meant
mediocre	mediocre
meets	meets
member	member
memorable	memorable
memory	memory
men	men
mess	mess
metal	metal
mgm	mgm
mid	mid
military	military
mind	mind
minded	minded
mindless	mindless
minutes	minutes
misery	misery
miss	miss
mission	mission
mistake	mistake
mitchell	mitchell
modern	modern
money	money
monotonous	monotonous
monster	monster
monsters	monsters
more	more
mother	mother
movie	movie
movies	movies
much	much
murder	murder
murders	murders
muscle	muscle
music	music
musical	musical
must	must
mutual	mutual
my	my
myself	myself
mystery	mystery
named	named
naturally	naturally
nazi	nazi
needed	needed
needs	needs
never	never
new	new
nice	nice
night	night
no	no
noir	noir
none	none
nor	nor
normally	normally
not	not
notch	notch
noted	noted
nothing	nothing
now	now
nowhere	nowhere
object	object
obsessive	obsessive
occur	occur
of	of
off	off
offered	offered
officer	officer
official	official
oh	oh
ok	ok
okay	okay
old	old
older	older
on	on
one	one
only	only
opinion	opinion
opportunity	opportunity
or	or
original	original
oscar	oscar
other	other
otherwise	otherwise
our	our
out	out
outstanding	outstanding
over	over
overrated	overrated
own	own
paced	paced
paid	paid
pain	pain
parking	parking
part	part
particular	particular
partner	partner
passion	passion
past	past
pathetic	pathetic
people	people
perfect	perfect
performance	performance
performances	performances
personal	personal
photo	photo
piano	piano
pick	pick
picked	picked
pictures	pictures
pile	pile
pitiful	pitiful
place	place
plain	plain
planet	planet
play	play
played	played
players	players
plays	plays
pleasantly	pleasantly
please	please
pleased	pleased
pleasure	pleasure
plenty	plenty
plot	plot
plus	plus
poignant	poignant
point	point
pointless	pointless
poke	poke
police	police
political	political
poor	poor
poorly	poorly
popular	popular
potential	potential
potty	potty
power	power
powerful	powerful
practical	practical
practice	practice
predictable	predictable
premise	premise
president	president
pretend	pretend
pretentious	pretentious
pretty	pretty
price	price
probably	probably
problem	problem
problems	problems
process	process
product	product
propaganda	propaganda
proves	proves
provided	provided
provides	provides
purchased	purchased
pure	pure
put	put
quality	quality
question	question
quite	quite
quot	quot
range	range
rare	rare
rate	rate
rather	rather
rave	rave
re	re
read	read
reading	reading
real	real
really	really
reason	reason
recently	recently
recommend	recommend
recommended	recommended
redeem	redeem
redeeming	redeeming
reduced	reduced
reed	reed
refreshing	refreshing
refund	refund
refuses	refuses
regarding	regarding
regardless	regardless
regret	regret
regular	regular
relaxed	relaxed
release	release
relief	relief
religious	religious
relive	relive
rent	rent
rental	rental
rented	rented
repetitive	repetitive
replace	replace
replacement	replacement
respected	respected
returned	returned
reveals	reveals
revenge	revenge
review	review
reviewers	reviewers
reviews	reviews
ride	ride
ridiculous	ridiculous
right	right
rip	rip
roberts	roberts
role	role
romance	romance
rose	rose
rotten	rotten
ruined	ruined
run	run
running	running
s	s
sadly	sadly
said	said
sam	sam
samurai	samurai
sandler	sandler
save	save
saw	saw
say	say
scene	scene
scenery	scenery
scenes	scenes
scheme	scheme
school	school
scott	scott
screen	screen
script	script
season	season
seat	seat
second	second
seconds	seconds
see	see
seeing	seeing
seem	seem
seemed	seemed
seems	seems
seen	seen
segment	segment
select	select
send	send
sense	sense
sequences	sequences
series	series
set	set
setting	setting
sex	sex
shaky	shaky
shame	shame
shape	shape
sharing	sharing
sharp	sharp
she	she
shoes	shoes
shoot	shoot
shooting	shooting
shoots	shoots
short	short
shorts	shorts
shot	shot
should	should
show	show
shows	shows
sick	sick
side	side
sided	sided
single	single
skill	skill
skip	skip
sky	sky
small	small
smart	smart
snow	snow
so	so
solid	solid
some	some
something	something
sometimes	sometimes
son	son
song	song
songs	songs
soon	soon
sophisticated	sophisticated
sorry	sorry
sort	sort
sorts	sorts
soul	soul
sounded	sounded
soundtrack	soundtrack
southern	southern
soviet	soviet
special	special
spectacular	spectacular
splendid	splendid
spoiled	spoiled
spoiler	spoiler
spring	spring
st	st
stage	stage
stages	stages
standard	standard
stands	stands
star	star
stars	stars
started	started
states	states
stay	stay
steal	steal
step	step
stephen	stephen
stereo	stereo
steven	steven
stiff	stiff
still	still
stinker	stinker
stinks	stinks
stop	stop
stops	stops
store	store
story	story
strength	strength
striking	striking
strong	strong
struggle	struggle
stunning	stunning
stupid	stupid
subtlety	subtlety
such	such
sucked	sucked
sucks	sucks
suffers	suffers
suicide	suicide
sung	sung
superb	superb
superbly	superbly
supported	supported
supporting	supporting
supposed	supposed
sure	sure
surprised	surprised
surprising	surprising
suspenseful	suspenseful
sweat	sweat
sweet	sweet
t	t
take	take
takes	takes
tale	tale
talent	talent
talked	talked
taylor	taylor
teacher	teacher
team	team
techniques	techniques
tedious	tedious
television	television
tell	tell
tells	tells
terms	terms
terrible	terrible
terrific	terrific
terror	terror
terrorist	terrorist
than	than
thanks	thanks
that	that
the	the
theater	theater
theatrical	theatrical
their	their
them	them
then	then
there	there
these	these
they	they
thief	thief
thin	thin
thing	thing
things	things
think	think
thinking	thinking
thinks	thinks
this	this
those	those
though	though
thousands	thousands
three	three
threw	threw
through	through
throw	throw
throwing	throwing
tiger	tiger
time	time
timeless	timeless
times	times
tired	tired
title	title
to	to
today	today
tone	tone
too	too
top	top
tormented	tormented
total	total
touch	touch
touching	touching
tour	tour
towards	towards
toy	toy
tradition	tradition
traditional	traditional
trail	trail
trailer	trailer
train	train
trash	trash
travesty	travesty
treat	treat
tried	tried
trilogy	trilogy
trite	trite
trouble	trouble
true	true
truly	truly
truth	truth
trying	trying
turn	turn
turned	turned
turns	turns
twists	twists
two	two
unbelievable	unbelievable
uncomfortable	uncomfortable
unconvincing	unconvincing
underground	underground
underrated	underrated
understand	understand
unexpected	unexpected
unforgettable	unforgettable
unfortunately	unfortunately
unfunny	unfunny
uninspired	uninspired
uninteresting	uninteresting
unit	unit
united	united
unless	unless
unoriginal	unoriginal
unpleasant	unpleasant
unrealistic	unrealistic
until	until
unwatchable	unwatchable
up	up
us	us
usa	usa
used	used
utter	utter
utterly	utterly
vapid	vapid
various	various
ve	ve
very	very
video	video
vietnam	vietnam
view	view
viewed	viewed
vincent	vincent
visual	visual
w	w
wait	wait
wake	wake
walked	walked
wanna	wanna
want	want
wanted	wanted
wants	wants
war	war
was	was
wasn	wasn
waste	waste
wasted	wasted
wasting	wasting
watch	watch
watchable	watchable
watched	watched
watching	watching
way	way
wayne	wayne
ways	ways
we	we
weird	weird
well	well
went	went
were	were
what	what
whatsoever	whatsoever
when	when
whenever	whenever
where	where
whereas	whereas
which	which
while	while
who	who
whole	whole
whom	whom
why	why
widescreen	widescreen
wife	wife
will	will
winner	winner
with	with
within	within
women	women
won	won
wonderful	wonderful
wonderfully	wonderfully
woo	woo
wood	wood
wooden	wooden
words	words
work	work
working	working
workout	workout
works	works
world	world
worry	worry
worse	worse
worst	worst
worth	worth
worthwhile	worthwhile
would	would
wow	wow
write	write
writer	writer
writers	writers
written	written
year	year
years	years
you	you
young	young
your	your
yourself	yourself
yuck	yuck
zero	zero
