2	2
3	3
4	4
5	5
a	a
able	able
about	about
above	above
addition	addition
again	again
ahead	ahead
along	along
also	also
always	always
am	am
amazing	amazing
an	an
and	and
anyone	anyone
are	are
as	as
at	at
attempt	attempt
away	away
awful	awful
b	b
back	back
bad	bad
barely	barely
based	based
beautiful	beautiful
beautifully	beautifully
because	because
been	been
bend	bend
best	best
better	better
bonus	bonus
boot	boot
both	both
bother	bother
budget	budget
bunch	bunch
but	but
button	button
buy	buy
buying	buying
by	by
carefully	carefully
cause	cause
cheaper	cheaper
chicago	chicago
choose	choose
city	city
classic	classic
collection	collection
come	come
considering	considering
could	could
crap	crap
crappy	crappy
crisp	crisp
d	d
day	day
de	de
deal	deal
deep	deep
definitely	definitely
destroyed	destroyed
didn	didn
difficulty	difficulty
disappointed	disappointed
disappointing	disappointing
disappointment	disappointment
do	do
does	does
doesnt	doesnt
don	don
down	down
drive	drive
drops	drops
each	each
effort	effort
either	either
else	else
enjoy	enjoy
enjoyable	enjoyable
enjoyed	enjoyed
even	even
ever	ever
everyone	everyone
everything	everything
excellent	excellent
except	except
exceptional	exceptional
expected	expected
experience	experience
explain	explain
extras	extras
fails	fails
family	family
fantastic	fantastic
far	far
fast	fast
favorite	favorite
features	features
fell	fell
felt	felt
find	find
first	first
fits	fits
flat	flat
for	for
forward	forward
four	four
from	from
fun	fun
garbage	garbage
gem	gem
gives	gives
go	go
going	going
gold	gold
good	good
got	got
great	great
greatest	greatest
had	had
half	half
hard	hard
has	has
have	have
having	having
he	he
here	here
highly	highly
his	his
hooked	hooked
horrible	horrible
hours	hours
how	how
however	however
huge	huge
husband	husband
i	i
impressed	impressed
impressive	impressive
in	in
includes	includes
instead	instead
is	is
it	it
jack	jack
joke	joke
just	just
kept	kept
kill	kill
know	know
lacks	lacks
lame	lame
least	least
let	let
levels	levels
life	life
like	like
likes	likes
line	line
little	little
living	living
ll	ll
lol	lol
look	look
looked	looked
looks	looks
los	los
love	love
loved	loved
low	low
make	make
man	man
many	many
may	may
maybe	maybe
me	me
mean	mean
mess	mess
minutes	minutes
moment	moment
money	money
monster	monster
more	more
movie	movie
much	much
musical	musical
must	must
my	my
named	named
needed	needed
never	never
next	next
nice	nice
no	no
not	not
notch	notch
nothing	nothing
occasion	occasion
of	of
off	off
oh	oh
old	old
on	on
one	one
only	only
or	or
other	other
our	our
outstanding	outstanding
over	over
own	own
owning	owning
paid	paid
part	part
past	past
perfect	perfect
performance	performance
personal	personal
played	played
player	player
playing	playing
pleasure	pleasure
plenty	plenty
poor	poor
poorly	poorly
potential	potential
power	power
powerful	powerful
problem	problem
product	product
purchase	purchase
purchased	purchased
put	put
quality	quality
rare	rare
re	re
read	read
reason	reason
recommend	recommend
recommended	recommended
refund	refund
regret	regret
regular	regular
remains	remains
review	review
reviewers	reviewers
reviews	reviews
ridiculous	ridiculous
rip	rip
ripped	ripped
rock	rock
room	room
s	s
said	said
save	save
seconds	seconds
see	see
seemed	seemed
seems	seems
shame	shame
sharing	sharing
should	should
shows	shows
slow	slow
so	so
solid	solid
some	some
something	something
son	son
song	song
sorry	sorry
standard	standard
stars	stars
stay	stay
steal	steal
still	still
stops	stops
strong	strong
stupid	stupid
sucks	sucks
superb	superb
supposed	supposed
sweat	sweat
sweet	sweet
t	t
takes	takes
television	television
terrible	terrible
terrific	terrific
than	than
that	that
the	the
there	there
they	they
thin	thin
thing	thing
thinking	thinking
this	this
though	though
three	three
tiger	tiger
time	time
times	times
to	to
took	took
top	top
tried	tried
truly	truly
trying	trying
turned	turned
tv	tv
two	two
unbelievable	unbelievable
uncomfortable	uncomfortable
unfortunately	unfortunately
unit	unit
up	up
ve	ve
very	very
want	want
was	was
waste	waste
wasted	wasted
wasting	wasting
watch	watch
ways	ways
well	well
went	went
were	were
what	what
whatsoever	whatsoever
when	when
who	who
why	why
will	will
with	with
within	within
won	won
wonderful	wonderful
wonderfully	wonderfully
wood	wood
worry	worry
worse	worse
worst	worst
worth	worth
worthless	worthless
would	would
years	years
you	you
your	your
yourself	yourself
