1	1
2	2
3	3
4	4
5	5
a	a
about	about
above	above
actually	actually
add	add
addition	addition
adore	adore
after	after
again	again
age	age
ahead	ahead
all	all
allows	allows
along	along
also	also
although	although
always	always
amazing	amazing
an	an
and	and
another	another
anyone	anyone
are	are
as	as
at	at
avoid	avoid
away	away
awesome	awesome
awful	awful
bad	bad
barely	barely
be	be
beautiful	beautiful
beautifully	beautifully
beauty	beauty
been	been
behind	behind
best	best
better	better
bonus	bonus
book	book
both	both
bother	bother
boy	boy
breaks	breaks
budget	budget
bunch	bunch
burned	burned
business	business
but	but
buy	buy
carefully	carefully
cheaper	cheaper
chicago	chicago
classic	classic
club	club
collection	collection
comparing	comparing
condition	condition
considering	considering
core	core
could	could
course	course
cracking	cracking
crap	crap
creating	creating
day	day
deal	deal
definitely	definitely
delicious	delicious
did	did
didn	didn
difficulty	difficulty
disappointed	disappointed
disappointing	disappointing
disappointment	disappointment
do	do
does	does
don	don
done	done
dull	dull
each	each
effort	effort
either	either
else	else
enjoy	enjoy
enjoyable	enjoyable
enjoyed	enjoyed
even	even
event	event
everyone	everyone
everything	everything
excellent	excellent
exceptional	exceptional
extras	extras
fabulous	fabulous
fails	fails
family	family
fancy	fancy
fantastic	fantastic
fault	fault
favor	favor
favorite	favorite
felt	felt
finest	finest
fits	fits
for	for
fresh	fresh
from	from
fully	fully
fun	fun
garbage	garbage
gave	gave
gem	gem
generation	generation
get	get
getting	getting
gives	gives
go	go
goes	goes
going	going
gold	gold
golden	golden
good	good
got	got
great	great
greatest	greatest
group	group
had	had
half	half
hard	hard
has	has
hate	hate
hated	hated
have	have
having	having
he	he
highly	highly
his	his
holes	holes
hooked	hooked
horrible	horrible
hours	hours
how	how
huge	huge
i	i
in	in
included	included
includes	includes
incredible	incredible
instead	instead
iron	iron
is	is
it	it
joke	joke
just	just
law	law
least	least
let	let
levels	levels
life	life
like	like
line	line
little	little
living	living
ll	ll
lol	lol
look	look
looked	looked
looks	looks
love	love
loved	loved
low	low
man	man
marvelous	marvelous
maybe	maybe
me	me
mean	mean
mess	mess
metal	metal
minutes	minutes
money	money
more	more
much	much
must	must
my	my
needed	needed
needs	needs
never	never
nice	nice
no	no
not	not
notch	notch
note	note
nothing	nothing
now	now
of	of
off	off
oh	oh
ok	ok
old	old
older	older
on	on
once	once
one	one
only	only
or	or
other	other
otherwise	otherwise
out	out
outstanding	outstanding
over	over
own	own
owning	owning
paid	paid
past	past
people	people
perfect	perfect
personal	personal
place	place
poor	poor
poorly	poorly
popular	popular
potential	potential
probably	probably
problem	problem
problems	problems
process	process
product	product
professional	professional
purchase	purchase
purchased	purchased
puts	puts
quality	quality
quot	quot
range	range
rare	rare
re	re
read	read
really	really
reason	reason
recommend	recommend
recommended	recommended
refund	refund
regret	regret
regular	regular
review	review
reviews	reviews
ridiculous	ridiculous
ruined	ruined
s	s
save	save
say	say
season	season
second	second
seconds	seconds
see	see
seemed	seemed
seems	seems
seen	seen
should	should
shows	shows
slowly	slowly
smart	smart
so	so
solid	solid
some	some
something	something
son	son
sorry	sorry
spoiled	spoiled
star	star
stay	stay
still	still
stop	stop
strong	strong
stupid	stupid
sucks	sucks
superb	superb
supposed	supposed
swear	swear
t	t
takes	takes
terrible	terrible
terrific	terrific
than	than
that	that
the	the
them	them
there	there
they	they
thing	thing
thinking	thinking
this	this
those	those
time	time
times	times
to	to
today	today
too	too
top	top
toy	toy
treat	treat
tried	tried
turned	turned
uncomfortable	uncomfortable
uneven	uneven
unfortunately	unfortunately
unit	unit
until	until
up	up
usa	usa
use	use
ve	ve
very	very
view	view
want	want
wanted	wanted
was	was
wasn	wasn
waste	waste
wasted	wasted
wasting	wasting
water	water
ways	ways
well	well
went	went
what	what
whatsoever	whatsoever
when	when
while	while
who	who
why	why
will	will
with	with
within	within
won	won
wonderful	wonderful
wonderfully	wonderfully
wood	wood
wooden	wooden
world	world
worry	worry
worse	worse
worst	worst
worth	worth
would	would
write	write
year	year
years	years
you	you
young	young
your	your
yourself	yourself
zero	zero
