21	21
a	a
above	above
acting	acting
addition	addition
adventure	adventure
age	age
all	all
along	along
also	also
although	although
always	always
amazing	amazing
among	among
an	an
and	and
another	another
any	any
anyone	anyone
appreciate	appreciate
are	are
as	as
at	at
attempt	attempt
attempted	attempted
awesome	awesome
awful	awful
bad	bad
barely	barely
barry	barry
basically	basically
be	be
beautiful	beautiful
beauty	beauty
because	because
become	become
becoming	becoming
been	been
before	before
begins	begins
behind	behind
best	best
betrayal	betrayal
better	better
bored	bored
boring	boring
both	both
bother	bother
breaks	breaks
brilliant	brilliant
brought	brought
bunch	bunch
but	but
buy	buy
buying	buying
captures	captures
carefully	carefully
cast	cast
catholic	catholic
character	character
chicago	chicago
christ	christ
christians	christians
city	city
classic	classic
collection	collection
comfortable	comfortable
commentary	commentary
complaint	complaint
concept	concept
continues	continues
could	could
course	course
crossing	crossing
cut	cut
day	day
deal	deal
deep	deep
delicious	delicious
delightful	delightful
destroyed	destroyed
detailed	detailed
development	development
did	did
didn	didn
disappoint	disappoint
disappointed	disappointed
disappointing	disappointing
disappointment	disappointment
do	do
dogs	dogs
don	don
done	done
dull	dull
dumb	dumb
each	each
easy	easy
edge	edge
editing	editing
effort	effort
either	either
engaged	engaged
enjoy	enjoy
enjoyable	enjoyable
enjoyed	enjoyed
enjoys	enjoys
entertaining	entertaining
european	european
eve	eve
even	even
everyone	everyone
everything	everything
excellent	excellent
exceptional	exceptional
exciting	exciting
expected	expected
expecting	expecting
explanation	explanation
fabulous	fabulous
fails	fails
family	family
fantastic	fantastic
fault	fault
favor	favor
favorite	favorite
favorites	favorites
features	features
feel	feel
felt	felt
fighting	fighting
figures	figures
find	find
finds	finds
first	first
fits	fits
flat	flat
for	for
form	form
found	found
friendship	friendship
fully	fully
fun	fun
gain	gain
gave	gave
gem	gem
generation	generation
girl	girl
gives	gives
glory	glory
gold	gold
golden	golden
good	good
got	got
great	great
greatest	greatest
greed	greed
group	group
had	had
hard	hard
has	has
hated	hated
have	have
having	having
he	he
heart	heart
highly	highly
hilarious	hilarious
his	his
historian	historian
hooked	hooked
hope	hope
horrible	horrible
hours	hours
how	how
however	however
humorous	humorous
i	i
in	in
includes	includes
including	including
incredible	incredible
inevitable	inevitable
insight	insight
insightful	insightful
instead	instead
intense	intense
intent	intent
into	into
introduced	introduced
introduces	introduces
introduction	introduction
is	is
it	it
jack	jack
job	job
john	john
just	just
kept	kept
kill	kill
know	know
lacking	lacking
last	last
law	law
learns	learns
least	least
let	let
letting	letting
levels	levels
liberal	liberal
life	life
lifetime	lifetime
like	like
ll	ll
look	look
looked	looked
looks	looks
lot	lot
love	love
loved	loved
low	low
magical	magical
magnificent	magnificent
make	make
makes	makes
man	man
many	many
maybe	maybe
me	me
mean	mean
meant	meant
men	men
mess	mess
minded	minded
minutes	minutes
money	money
more	more
movie	movie
mrs	mrs
much	much
must	must
my	my
named	named
needs	needs
never	never
night	night
no	no
not	not
nothing	nothing
of	of
off	off
old	old
on	on
one	one
only	only
or	or
other	other
our	our
out	out
outstanding	outstanding
own	own
paid	paid
part	part
passionate	passionate
past	past
people	people
perfect	perfect
performance	performance
personal	personal
pile	pile
planet	planet
play	play
played	played
pleased	pleased
poignant	poignant
point	point
political	political
poor	poor
poorly	poorly
potential	potential
power	power
powerful	powerful
practical	practical
predictable	predictable
premise	premise
previous	previous
princess	princess
principle	principle
problem	problem
process	process
product	product
purchased	purchased
put	put
quality	quality
quot	quot
racist	racist
rape	rape
rare	rare
re	re
read	read
really	really
reason	reason
recommend	recommend
recommended	recommended
refreshing	refreshing
regular	regular
rent	rent
reveal	reveal
reviewers	reviewers
reviews	reviews
ridiculous	ridiculous
rock	rock
role	role
rose	rose
s	s
safe	safe
said	said
save	save
sea	sea
season	season
seat	seat
see	see
seemed	seemed
shame	shame
sharing	sharing
should	should
skip	skip
smart	smart
snow	snow
so	so
solid	solid
some	some
son	son
song	song
sorry	sorry
soviet	soviet
st	st
standard	standard
step	step
stephen	stephen
still	still
story	story
strong	strong
stunning	stunning
stupid	stupid
substance	substance
suicide	suicide
superb	superb
supporting	supporting
supposed	supposed
sure	sure
sweet	sweet
t	t
takes	takes
tale	tale
team	team
tedious	tedious
television	television
terrible	terrible
terrific	terrific
than	than
the	the
there	there
these	these
they	they
thing	thing
things	things
thinking	thinking
this	this
thousands	thousands
threat	threat
three	three
time	time
to	to
today	today
too	too
topic	topic
tradition	tradition
traditional	traditional
train	train
tried	tried
trilogy	trilogy
truth	truth
turned	turned
twists	twists
understand	understand
unexpected	unexpected
unfortunately	unfortunately
unit	unit
united	united
unless	unless
until	until
unusual	unusual
up	up
usa	usa
various	various
ve	ve
very	very
vietnam	vietnam
view	view
want	want
wanted	wanted
war	war
wars	wars
was	was
waste	waste
wasted	wasted
we	we
weak	weak
well	well
went	went
what	what
when	when
which	which
while	while
who	who
why	why
wife	wife
will	will
william	william
winner	winner
with	with
within	within
wolf	wolf
won	won
wonderful	wonderful
wonderfully	wonderfully
wonders	wonders
world	world
worse	worse
worst	worst
worth	worth
would	would
write	write
writers	writers
written	written
wwii	wwii
years	years
you	you
young	young
your	your
