00	00
1	1
10	10
2	2
20	20
2005	2005
3	3
30	30
4	4
42	42
4gb	4gb
5	5
512	512
6	6
75	75
802	802
a	a
about	about
above	above
accuracy	accuracy
accurate	accurate
actual	actual
actually	actually
adapter	adapter
added	added
additional	additional
address	address
adequate	adequate
advise	advise
affordable	affordable
after	after
again	again
against	against
ago	ago
alarm	alarm
all	all
allowed	allowed
allows	allows
almost	almost
alone	alone
alot	alot
already	already
also	also
altec	altec
altogether	altogether
always	always
am	am
amazing	amazing
amazon	amazon
amplifier	amplifier
an	an
analog	analog
and	and
annoying	annoying
another	another
answering	answering
any	any
anymore	anymore
anyone	anyone
anything	anything
apparently	apparently
appears	appears
are	are
arm	arm
around	around
arrived	arrived
as	as
asked	asked
at	at
audio	audio
audiophile	audiophile
av	av
avail	avail
avoid	avoid
away	away
awesome	awesome
awful	awful
back	back
backpack	backpack
bad	bad
barely	barely
base	base
based	based
basic	basic
bass	bass
batteries	batteries
battery	battery
be	be
beat	beat
because	because
become	become
been	been
before	before
beginning	beginning
believe	believe
belt	belt
besides	besides
best	best
better	better
between	between
beware	beware
big	big
bit	bit
blank	blank
bonus	bonus
bose	bose
bought	bought
brainer	brainer
brand	brand
break	break
breaks	breaks
breeze	breeze
bright	bright
brightness	brightness
broke	broke
broken	broken
brother	brother
budget	budget
building	building
built	built
bulky	bulky
burned	burned
but	but
buttons	buttons
buy	buy
buyer	buyer
by	by
cable	cable
call	call
called	called
calls	calls
camcorder	camcorder
came	came
camera	camera
cameras	cameras
can	can
canal	canal
cancel	cancel
cannot	cannot
canon	canon
cant	cant
capable	capable
capacity	capacity
card	card
carry	carry
case	case
causes	causes
cell	cell
center	center
charge	charge
cheap	cheap
cheapest	cheapest
claim	claim
clarity	clarity
class	class
clean	clean
clear	clear
click	click
clip	clip
college	college
color	color
colors	colors
come	come
comes	comes
comfortable	comfortable
comfortably	comfortably
comment	comment
common	common
compact	compact
companies	companies
company	company
compare	compare
compared	compared
compatible	compatible
complaint	complaint
complaints	complaints
completely	completely
computer	computer
condition	condition
connect	connect
connection	connection
cons	cons
constantly	constantly
consumer	consumer
contacted	contacted
contacts	contacts
continue	continue
control	control
controls	controls
cost	cost
could	could
count	count
covers	covers
crap	crap
crappy	crappy
crashes	crashes
crisp	crisp
cross	cross
crystal	crystal
cups	cups
cursor	cursor
customer	customer
customers	customers
cut	cut
d	d
day	day
days	days
dead	dead
deal	deal
dealing	dealing
decent	decent
default	default
defective	defective
definitely	definitely
delivered	delivered
delivery	delivery
department	department
depending	depending
description	description
design	design
desk	desk
detailed	detailed
detect	detect
device	device
did	did
didn	didn
died	died
dies	dies
difference	difference
different	different
digital	digital
direct	direct
disappointed	disappointed
disappointing	disappointing
disappointment	disappointment
disconnected	disconnected
discovered	discovered
disks	disks
displays	displays
distortion	distortion
dj	dj
do	do
dock	dock
documents	documents
does	does
doesn	doesn
doesnt	doesnt
don	don
download	download
downloading	downloading
downside	downside
draw	draw
drive	drive
drops	drops
due	due
duo	duo
durable	durable
dvd	dvd
ear	ear
early	early
ease	ease
easier	easier
easily	easily
easy	easy
effect	effect
eight	eight
either	either
else	else
emails	emails
end	end
english	english
enjoy	enjoy
enough	enough
epson	epson
eq	eq
equalizer	equalizer
equipment	equipment
error	error
errors	errors
especially	especially
even	even
ever	ever
every	every
everyday	everyday
everything	everything
exact	exact
exactly	exactly
excellent	excellent
exchange	exchange
excited	excited
expect	expect
expected	expected
experience	experience
extra	extra
factor	factor
factory	factory
fail	fail
failed	failed
fails	fails
failure	failure
fairly	fairly
family	family
fantastic	fantastic
far	far
fast	fast
faster	faster
fault	fault
faulty	faulty
favorite	favorite
feature	feature
features	features
feel	feel
fell	fell
field	field
figure	figure
finally	finally
find	find
fine	fine
firmware	firmware
first	first
fits	fits
fix	fix
fixed	fixed
flaw	flaw
floor	floor
fm	fm
for	for
forget	forget
found	found
freeze	freeze
freezes	freezes
friendly	friendly
friends	friends
from	from
front	front
frustrated	frustrated
frustrating	frustrating
frustration	frustration
full	full
fun	fun
games	games
gaming	gaming
garbage	garbage
garmin	garmin
gave	gave
gear	gear
generally	generally
get	get
getting	getting
give	give
given	given
glad	glad
go	go
goes	goes
going	going
gold	gold
good	good
google	google
got	got
gps	gps
great	great
grip	grip
guess	guess
had	had
half	half
handsets	handsets
handy	handy
happened	happened
happens	happens
happy	happy
hard	hard
hardware	hardware
has	has
have	have
haven	haven
having	having
hd	hd
headband	headband
headphone	headphone
headphones	headphones
heard	heard
heavy	heavy
help	help
hi	hi
high	high
higher	higher
highly	highly
highs	highs
highway	highway
hold	hold
holds	holds
home	home
hooked	hooked
hooking	hooking
hope	hope
hoping	hoping
horrible	horrible
hour	hour
hours	hours
house	house
however	however
hp	hp
i	i
if	if
important	important
impossible	impossible
impressed	impressed
in	in
included	included
including	including
incredible	incredible
inexpensive	inexpensive
ink	ink
input	input
install	install
interested	interested
interference	interference
internal	internal
into	into
intuitive	intuitive
investment	investment
ipod	ipod
is	is
it	it
item	item
its	its
job	job
joke	joke
junk	junk
just	just
key	key
kind	kind
know	know
known	known
knows	knows
label	label
labels	labels
lacks	lacks
lansing	lansing
laptop	laptop
laser	laser
last	last
lasted	lasted
leather	leather
lemon	lemon
less	less
levels	levels
life	life
light	light
like	like
liked	liked
line	line
link	link
linksys	linksys
listen	listen
listening	listening
little	little
lives	lives
living	living
ll	ll
loads	loads
long	long
longer	longer
look	look
looked	looked
looking	looking
looks	looks
lost	lost
lot	lot
love	love
loved	loved
low	low
luck	luck
m	m
mac	mac
machine	machine
made	made
mail	mail
main	main
major	major
make	make
makes	makes
manufacturer	manufacturer
many	many
matter	matter
may	may
maybe	maybe
mb	mb
me	me
means	means
meant	meant
media	media
meet	meet
memorex	memorex
memory	memory
menu	menu
message	message
meter	meter
microphone	microphone
minor	minor
minutes	minutes
misleading	misleading
mistake	mistake
modem	modem
money	money
monitor	monitor
month	month
months	months
more	more
most	most
mostly	mostly
motion	motion
mouse	mouse
movie	movie
movies	movies
moving	moving
mp3	mp3
mp3s	mp3s
much	much
music	music
must	must
my	my
neck	neck
need	need
needed	needed
needs	needs
negative	negative
negatives	negatives
never	never
new	new
next	next
nice	nice
no	no
normal	normal
not	not
nothing	nothing
noticeable	noticeable
now	now
o	o
of	of
off	off
offered	offered
offering	offering
oh	oh
ok	ok
old	old
on	on
once	once
one	one
only	only
opinion	opinion
option	option
or	or
ordered	ordered
original	original
other	other
others	others
out	out
outlet	outlet
output	output
outstanding	outstanding
over	over
overall	overall
own	own
owned	owned
owner	owner
owning	owning
painful	painful
pair	pair
paper	paper
papers	papers
particular	particular
party	party
past	past
pay	pay
pen	pen
people	people
perfect	perfect
perform	perform
performance	performance
performed	performed
perhaps	perhaps
period	period
person	person
philips	philips
phone	phone
phones	phones
photo	photo
photos	photos
pictures	pictures
piece	piece
plane	plane
plantronics	plantronics
plastic	plastic
player	player
players	players
plays	plays
pleased	pleased
plenty	plenty
plug	plug
plugs	plugs
plus	plus
point	point
policy	policy
poor	poor
poorly	poorly
pop	pop
portable	portable
post	post
potential	potential
pouch	pouch
practice	practice
precise	precise
prefer	prefer
pretty	pretty
previous	previous
price	price
priced	priced
printing	printing
prints	prints
pro	pro
probably	probably
problem	problem
problems	problems
process	process
product	product
products	products
properly	properly
pros	pros
protector	protector
provided	provided
provides	provides
ps	ps
purchased	purchased
purchasing	purchasing
purpose	purpose
purposes	purposes
put	put
quality	quality
quick	quick
quickly	quickly
quit	quit
quite	quite
radio	radio
radios	radios
range	range
rca	rca
re	re
reach	reach
read	read
reading	reading
really	really
reasonably	reasonably
receipt	receipt
received	received
receiver	receiver
recently	recently
rechargeable	rechargeable
recommend	recommend
recommended	recommended
recording	recording
refund	refund
refurbished	refurbished
regular	regular
reliability	reliability
reliable	reliable
remote	remote
removable	removable
rep	rep
repair	repair
repeat	repeat
repeatedly	repeatedly
replacement	replacement
replacing	replacing
reply	reply
required	required
reset	reset
resolution	resolution
result	result
retract	retract
return	return
returned	returned
returning	returning
rich	rich
ridiculous	ridiculous
right	right
rip	rip
road	road
rock	rock
rocks	rocks
room	room
router	router
s	s
sad	sad
said	said
same	same
sandisk	sandisk
satisfied	satisfied
save	save
saved	saved
say	say
saying	saying
says	says
school	school
scratching	scratching
screen	screen
search	search
second	second
see	see
seemed	seemed
sell	sell
send	send
sending	sending
sensitivity	sensitivity
sent	sent
separate	separate
serious	serious
service	service
set	set
several	several
shame	shame
shielding	shielding
ship	ship
short	short
should	should
showing	showing
shut	shut
side	side
sign	sign
simple	simple
since	since
site	site
sitting	sitting
size	size
sized	sized
sleek	sleek
sleep	sleep
slightly	slightly
slim	slim
small	small
smaller	smaller
smart	smart
snap	snap
so	so
software	software
solid	solid
some	some
someone	someone
something	something
sometimes	sometimes
sony	sony
sound	sound
sounds	sounds
space	space
spare	spare
speaker	speaker
speakers	speakers
specific	specific
spoke	spoke
staples	staples
star	star
stars	stars
started	started
state	state
station	station
stay	stay
stereo	stereo
stick	stick
still	still
stop	stop
stopped	stopped
stops	stops
storage	storage
store	store
stores	stores
straight	straight
stuck	stuck
student	student
studio	studio
sturdy	sturdy
sub	sub
such	such
sucks	sucks
suction	suction
sudden	sudden
suggested	suggested
summer	summer
super	super
superb	superb
support	support
sure	sure
surge	surge
surprised	surprised
surprisingly	surprisingly
surround	surround
sweet	sweet
switch	switch
switched	switched
switches	switches
system	system
t	t
tablet	tablet
tag	tag
take	take
takes	takes
tech	tech
technical	technical
telephone	telephone
tell	tell
terrible	terrible
terrific	terrific
tested	tested
than	than
thank	thank
that	that
the	the
theater	theater
their	their
them	them
then	then
there	there
these	these
they	they
thick	thick
thin	thin
thing	thing
things	things
think	think
this	this
those	those
thought	thought
threw	threw
throw	throw
thru	thru
time	time
times	times
to	to
today	today
told	told
tomtom	tomtom
ton	ton
too	too
took	took
top	top
total	total
touch	touch
traffic	traffic
transfer	transfer
transmit	transmit
transmitter	transmitter
trash	trash
traveling	traveling
tried	tried
try	try
trying	trying
tunes	tunes
turn	turn
turned	turned
tv	tv
tvs	tvs
twice	twice
two	two
ugly	ugly
unable	unable
unacceptable	unacceptable
under	under
unfortunately	unfortunately
uniden	uniden
units	units
unless	unless
unplug	unplug
unreliable	unreliable
until	until
unusable	unusable
up	up
upset	upset
usb	usb
use	use
used	used
useful	useful
useless	useless
users	users
using	using
value	value
ve	ve
very	very
video	video
viewing	viewing
virtually	virtually
vivid	vivid
voice	voice
vs	vs
waiting	waiting
walkman	walkman
walls	walls
want	want
warned	warned
warranty	warranty
was	was
wasn	wasn
waste	waste
wasted	wasted
way	way
we	we
wear	wear
web	web
website	website
weeks	weeks
weight	weight
well	well
went	went
were	were
what	what
wheel	wheel
when	when
where	where
which	which
while	while
who	who
whole	whole
why	why
wide	wide
widescreen	widescreen
will	will
windows	windows
wires	wires
wiring	wiring
wish	wish
with	with
within	within
without	without
won	won
wonderful	wonderful
woofer	woofer
work	work
worked	worked
working	working
works	works
worried	worried
worry	worry
worse	worse
worst	worst
worth	worth
worthless	worthless
would	would
wouldn	wouldn
wow	wow
wpa	wpa
wrong	wrong
wrote	wrote
x	x
xm	xm
yeah	yeah
year	year
years	years
yellow	yellow
yes	yes
yet	yet
you	you
your	your
yourself	yourself
zoom	zoom
