1	1
10	10
13	13
16	16
2	2
20	20
3	3
30	30
4	4
5	5
6	6
75	75
80	80
9	9
a	a
able	able
about	about
accessories	accessories
accurate	accurate
actual	actual
actually	actually
added	added
addition	addition
additional	additional
address	address
advice	advice
advise	advise
affordable	affordable
after	after
again	again
against	against
ago	ago
all	all
allowed	allowed
allows	allows
alone	alone
already	already
also	also
always	always
am	am
amazing	amazing
amazon	amazon
an	an
and	and
annoying	annoying
another	another
any	any
anymore	anymore
anyone	anyone
anything	anything
apparently	apparently
appears	appears
apple	apple
appropriate	appropriate
are	are
arm	arm
around	around
as	as
asked	asked
asking	asking
at	at
avail	avail
avoid	avoid
away	away
awesome	awesome
awful	awful
back	back
bad	bad
barely	barely
bargain	bargain
based	based
basic	basic
battery	battery
be	be
beat	beat
beautiful	beautiful
because	because
been	been
before	before
believe	believe
besides	besides
best	best
better	better
beware	beware
big	big
bit	bit
bought	bought
box	box
brand	brand
break	break
breaks	breaks
brick	brick
bright	bright
broke	broke
broken	broken
budget	budget
built	built
bulky	bulky
burned	burned
but	but
buttons	buttons
buy	buy
buyer	buyer
by	by
call	call
called	called
came	came
can	can
cannot	cannot
capacity	capacity
car	car
causing	causing
center	center
change	change
changed	changed
charge	charge
charges	charges
cheap	cheap
checked	checked
clear	clear
click	click
college	college
color	color
colors	colors
come	come
comes	comes
comfortable	comfortable
comfortably	comfortably
comment	comment
companies	companies
company	company
comparable	comparable
compare	compare
compared	compared
complaint	complaint
complaints	complaints
computer	computer
con	con
concept	concept
condition	condition
cons	cons
constantly	constantly
contacted	contacted
control	control
controls	controls
corner	corner
cost	cost
could	could
count	count
course	course
covers	covers
crap	crap
crisp	crisp
cross	cross
crystal	crystal
cup	cup
customer	customer
customers	customers
cut	cut
d	d
day	day
days	days
dead	dead
decent	decent
defective	defective
definitely	definitely
delivery	delivery
department	department
depending	depending
description	description
design	design
designed	designed
desk	desk
device	device
dial	dial
did	did
didn	didn
died	died
dies	dies
different	different
disappointed	disappointed
disappointing	disappointing
disappointment	disappointment
do	do
does	does
doesn	doesn
doesnt	doesnt
don	don
downside	downside
draw	draw
drops	drops
due	due
durable	durable
during	during
dvd	dvd
early	early
ease	ease
easier	easier
easily	easily
easy	easy
effect	effect
either	either
elements	elements
else	else
english	english
enjoy	enjoy
enough	enough
entire	entire
error	error
especially	especially
even	even
eventually	eventually
ever	ever
every	every
everyday	everyday
everything	everything
exactly	exactly
excellent	excellent
exchange	exchange
excited	excited
expect	expect
expected	expected
expensive	expensive
experience	experience
extra	extra
eye	eye
fabulous	fabulous
fact	fact
factor	factor
fail	fail
failed	failed
fails	fails
failure	failure
family	family
fantastic	fantastic
far	far
fast	fast
faster	faster
fault	fault
favorite	favorite
feature	feature
feel	feel
fell	fell
felt	felt
few	few
figured	figured
find	find
fine	fine
first	first
fit	fit
fits	fits
fix	fix
fixed	fixed
flaw	flaw
flimsy	flimsy
floor	floor
follow	follow
for	for
forced	forced
forever	forever
form	form
found	found
four	four
free	free
freeze	freeze
friends	friends
from	from
front	front
frustrated	frustrated
frustrating	frustrating
frustration	frustration
fun	fun
functions	functions
further	further
gadget	gadget
garbage	garbage
gave	gave
get	get
gets	gets
getting	getting
given	given
glad	glad
go	go
goes	goes
going	going
gold	gold
good	good
got	got
great	great
guess	guess
guys	guys
had	had
half	half
hand	hand
handy	handy
happened	happened
happens	happens
happy	happy
hard	hard
hardware	hardware
has	has
have	have
haven	haven
having	having
heavy	heavy
height	height
held	held
help	help
helps	helps
high	high
higher	higher
highly	highly
hit	hit
hold	hold
holds	holds
hole	hole
home	home
hooked	hooked
hope	hope
hoping	hoping
horrible	horrible
hour	hour
hours	hours
house	house
how	how
however	however
i	i
if	if
ii	ii
image	image
impossible	impossible
impressed	impressed
impressive	impressive
in	in
included	included
incredible	incredible
inexpensive	inexpensive
interested	interested
into	into
investment	investment
is	is
it	it
item	item
job	job
joke	joke
junk	junk
just	just
keeps	keeps
key	key
kids	kids
kind	kind
kit	kit
kitchen	kitchen
know	know
known	known
knows	knows
label	label
lasted	lasted
latest	latest
leaving	leaving
lemon	lemon
less	less
lesson	lesson
levels	levels
light	light
like	like
liked	liked
link	link
little	little
live	live
lives	lives
living	living
ll	ll
locks	locks
long	long
look	look
looking	looking
looks	looks
lost	lost
lot	lot
loud	loud
love	love
loved	loved
low	low
lower	lower
luck	luck
m	m
made	made
mail	mail
major	major
make	make
makes	makes
making	making
managed	managed
manual	manual
materials	materials
matter	matter
may	may
maybe	maybe
me	me
meant	meant
mechanism	mechanism
meet	meet
message	message
minor	minor
minutes	minutes
misleading	misleading
mistake	mistake
money	money
month	month
months	months
more	more
most	most
mostly	mostly
move	move
moving	moving
much	much
must	must
my	my
need	need
needs	needs
negatives	negatives
never	never
new	new
next	next
nice	nice
nicely	nicely
no	no
normal	normal
not	not
nothing	nothing
now	now
number	number
o	o
obviously	obviously
of	of
off	off
offered	offered
offering	offering
often	often
ok	ok
old	old
on	on
once	once
one	one
only	only
opinion	opinion
or	or
ordered	ordered
original	original
other	other
out	out
outlet	outlet
outstanding	outstanding
over	over
overall	overall
overpriced	overpriced
own	own
owned	owned
owning	owning
package	package
pair	pair
particular	particular
past	past
pay	pay
people	people
perfect	perfect
perfectly	perfectly
performed	performed
perhaps	perhaps
person	person
phone	phone
pick	pick
picture	picture
pictures	pictures
piece	piece
pink	pink
plastic	plastic
pleased	pleased
plenty	plenty
plugged	plugged
plus	plus
pocket	pocket
point	point
pointed	pointed
policy	policy
poor	poor
poorly	poorly
pop	pop
portable	portable
post	post
potential	potential
powerful	powerful
precise	precise
prefer	prefer
pretty	pretty
previous	previous
price	price
priced	priced
prior	prior
pro	pro
probably	probably
problem	problem
problems	problems
product	product
products	products
promised	promised
properly	properly
pros	pros
protect	protect
provides	provides
purchased	purchased
purchasing	purchasing
purpose	purpose
quality	quality
quick	quick
quickly	quickly
quit	quit
quite	quite
range	range
re	re
reach	reach
realize	realize
really	really
reasonably	reasonably
received	received
recommend	recommend
recommended	recommended
refund	refund
refurbished	refurbished
regular	regular
remote	remote
rep	rep
repair	repair
repeat	repeat
repeatedly	repeatedly
replace	replace
replacement	replacement
reports	reports
reset	reset
rest	rest
return	return
returned	returned
returning	returning
review	review
ridiculous	ridiculous
right	right
rock	rock
rocks	rocks
room	room
s	s
sad	sad
sadly	sadly
said	said
same	same
satisfied	satisfied
save	save
saved	saved
say	say
saying	saying
says	says
school	school
screen	screen
search	search
second	second
securely	securely
see	see
seem	seem
seemed	seemed
seen	seen
sell	sell
seller	seller
send	send
sending	sending
sent	sent
separate	separate
service	service
set	set
several	several
shame	shame
ship	ship
shipping	shipping
shopping	shopping
short	short
should	should
shut	shut
side	side
sign	sign
simple	simple
since	since
site	site
sitting	sitting
sized	sized
sleek	sleek
slightly	slightly
small	small
smaller	smaller
smooth	smooth
so	so
solid	solid
some	some
someone	someone
something	something
sound	sound
source	source
space	space
spare	spare
special	special
specific	specific
spent	spent
standard	standard
stars	stars
started	started
starting	starting
static	static
stay	stay
stays	stays
still	still
stop	stop
stopped	stopped
stops	stops
store	store
stores	stores
storing	storing
stronger	stronger
stuck	stuck
stylish	stylish
such	such
sucks	sucks
suction	suction
suggestion	suggestion
super	super
superb	superb
support	support
supposed	supposed
sure	sure
surprised	surprised
surprisingly	surprisingly
sweet	sweet
switched	switched
t	t
tag	tag
take	take
takes	takes
talk	talk
tape	tape
tech	tech
tell	tell
ten	ten
terrible	terrible
tested	tested
than	than
thank	thank
that	that
the	the
their	their
them	them
then	then
there	there
these	these
they	they
thick	thick
thin	thin
thing	thing
things	things
think	think
this	this
those	those
thought	thought
threw	threw
through	through
thru	thru
time	time
times	times
tired	tired
to	to
today	today
told	told
ton	ton
too	too
took	took
top	top
total	total
touch	touch
transfer	transfer
trash	trash
tried	tried
try	try
trying	trying
turn	turn
turned	turned
twice	twice
two	two
unable	unable
under	under
unfortunately	unfortunately
unit	unit
unless	unless
unplug	unplug
until	until
unusable	unusable
upset	upset
use	use
used	used
useful	useful
useless	useless
users	users
using	using
value	value
variety	variety
ve	ve
vendor	vendor
very	very
vs	vs
waiting	waiting
walls	walls
warned	warned
warranty	warranty
was	was
wasn	wasn
waste	waste
wasted	wasted
watch	watch
way	way
we	we
wear	wear
weeks	weeks
weight	weight
well	well
went	went
were	were
weren	weren
what	what
when	when
whenever	whenever
where	where
which	which
while	while
white	white
who	who
whole	whole
why	why
wide	wide
will	will
wires	wires
wish	wish
with	with
within	within
without	without
won	won
wonderful	wonderful
work	work
worked	worked
working	working
works	works
worried	worried
worry	worry
worse	worse
worst	worst
worth	worth
worthless	worthless
would	would
wouldn	wouldn
wow	wow
wrong	wrong
x	x
yeah	yeah
year	year
years	years
yellow	yellow
yesterday	yesterday
you	you
your	your
yourself	yourself
