1	1
10	10
16	16
18	18
2	2
20	20
25	25
2nd	2nd
3	3
30	30
42	42
5	5
6	6
75	75
a	a
able	able
about	about
above	above
abuse	abuse
accurate	accurate
actual	actual
actually	actually
add	add
added	added
additional	additional
adequate	adequate
advise	advise
affordable	affordable
after	after
again	again
against	against
ago	ago
agree	agree
alarm	alarm
all	all
allowed	allowed
allowing	allowing
allows	allows
almost	almost
alot	alot
also	also
altogether	altogether
always	always
am	am
amazing	amazing
amazon	amazon
an	an
and	and
annoying	annoying
another	another
any	any
anybody	anybody
anymore	anymore
anyone	anyone
anything	anything
apparently	apparently
appear	appear
appears	appears
are	are
around	around
arrived	arrived
as	as
asked	asked
at	at
audio	audio
auto	auto
avail	avail
avoid	avoid
away	away
awesome	awesome
awful	awful
awsome	awsome
back	back
bad	bad
band	band
barely	barely
based	based
basic	basic
bass	bass
be	be
beat	beat
because	because
becuase	becuase
been	been
before	before
begin	begin
being	being
believe	believe
belt	belt
besides	besides
best	best
better	better
beware	beware
big	big
bit	bit
black	black
blank	blank
bonus	bonus
bottom	bottom
bought	bought
brainer	brainer
brand	brand
break	break
breaks	breaks
brick	brick
bright	bright
broadcast	broadcast
broke	broke
broken	broken
budget	budget
built	built
burned	burned
burning	burning
but	but
button	button
buttons	buttons
buy	buy
buyer	buyer
by	by
cable	cable
call	call
called	called
camera	camera
cameras	cameras
can	can
cannot	cannot
canon	canon
capable	capable
capacity	capacity
card	card
carry	carry
carrying	carrying
case	case
cd	cd
cell	cell
center	center
cents	cents
changed	changed
charge	charge
checked	checked
clarity	clarity
clear	clear
click	click
clip	clip
college	college
color	color
combo	combo
comes	comes
comfortable	comfortable
coming	coming
comment	comment
companies	companies
company	company
comparable	comparable
compare	compare
compared	compared
complaining	complaining
complaint	complaint
complaints	complaints
completely	completely
connection	connection
cons	cons
constantly	constantly
contacted	contacted
contacts	contacts
convenient	convenient
cool	cool
could	could
count	count
covers	covers
crap	crap
crappy	crappy
crashes	crashes
crisp	crisp
cross	cross
crystal	crystal
cup	cup
customer	customer
customers	customers
d	d
day	day
days	days
dead	dead
deal	deal
defective	defective
definitely	definitely
depending	depending
description	description
desk	desk
detect	detect
device	device
did	did
didn	didn
died	died
difference	difference
different	different
direct	direct
disabled	disabled
disappointed	disappointed
disappointing	disappointing
disappointment	disappointment
disconnected	disconnected
discovered	discovered
displays	displays
dj	dj
do	do
does	does
doesn	doesn
doesnt	doesnt
don	don
down	down
downside	downside
draw	draw
drive	drive
due	due
early	early
ease	ease
easier	easier
easily	easily
easy	easy
editing	editing
effect	effect
eight	eight
either	either
elements	elements
else	else
english	english
enjoy	enjoy
enough	enough
equipment	equipment
error	error
errors	errors
especially	especially
even	even
eventually	eventually
ever	ever
every	every
everyday	everyday
exactly	exactly
excellent	excellent
excited	excited
expect	expect
expected	expected
experience	experience
extra	extra
fabulous	fabulous
fact	fact
factor	factor
factory	factory
failed	failed
fails	fails
failure	failure
fantastic	fantastic
far	far
fast	fast
faster	faster
fault	fault
faulty	faulty
favorite	favorite
feature	feature
features	features
feel	feel
fell	fell
felt	felt
finally	finally
find	find
fine	fine
first	first
fits	fits
fix	fix
fixed	fixed
flaw	flaw
flexible	flexible
flight	flight
floor	floor
following	following
for	for
form	form
found	found
freeze	freeze
friends	friends
from	from
front	front
frustrating	frustrating
frustration	frustration
fun	fun
game	game
games	games
gap	gap
garbage	garbage
gave	gave
get	get
getting	getting
give	give
given	given
glad	glad
go	go
goes	goes
going	going
gold	gold
good	good
got	got
great	great
guess	guess
guys	guys
had	had
half	half
hand	hand
handy	handy
happened	happened
happens	happens
happier	happier
happy	happy
has	has
hate	hate
have	have
haven	haven
having	having
hd	hd
hear	hear
help	help
high	high
highly	highly
highs	highs
hold	hold
holds	holds
home	home
hope	hope
horrible	horrible
hour	hour
how	how
hurt	hurt
i	i
ideal	ideal
if	if
images	images
impossible	impossible
impressed	impressed
impressive	impressive
improvement	improvement
in	in
included	included
includes	includes
incredible	incredible
inexpensive	inexpensive
input	input
instructions	instructions
into	into
investment	investment
is	is
it	it
item	item
its	its
jam	jam
job	job
joke	joke
junk	junk
just	just
key	key
kind	kind
kitchen	kitchen
know	know
laptop	laptop
larger	larger
laser	laser
lasted	lasted
later	later
latest	latest
leather	leather
leaving	leaving
lemon	lemon
lesson	lesson
levels	levels
lighter	lighter
lights	lights
like	like
liked	liked
line	line
link	link
listen	listen
listening	listening
little	little
lives	lives
living	living
ll	ll
loads	loads
locate	locate
long	long
longer	longer
look	look
looking	looking
looks	looks
loss	loss
lost	lost
lot	lot
lots	lots
loud	loud
love	love
loved	loved
low	low
luck	luck
m	m
machines	machines
made	made
major	major
make	make
makes	makes
making	making
many	many
materials	materials
matter	matter
may	may
maybe	maybe
me	me
meant	meant
media	media
memory	memory
message	message
messed	messed
microphone	microphone
mile	mile
minor	minor
minutes	minutes
misleading	misleading
mistake	mistake
money	money
months	months
more	more
most	most
mostly	mostly
move	move
movie	movie
movies	movies
moving	moving
much	much
music	music
must	must
my	my
neck	neck
need	need
negatives	negatives
network	network
never	never
new	new
next	next
nice	nice
nicely	nicely
no	no
not	not
nothing	nothing
now	now
number	number
of	of
off	off
offered	offered
offering	offering
often	often
oh	oh
ok	ok
old	old
on	on
once	once
one	one
only	only
open	open
opinion	opinion
or	or
original	original
originally	originally
other	other
out	out
outstanding	outstanding
over	over
overall	overall
own	own
packed	packed
painful	painful
paper	paper
past	past
pay	pay
pen	pen
people	people
perfect	perfect
perform	perform
performed	performed
perhaps	perhaps
period	period
person	person
phone	phone
photo	photo
photos	photos
pick	pick
picture	picture
pictures	pictures
piece	piece
pink	pink
place	place
plane	plane
plastic	plastic
player	player
plays	plays
pleased	pleased
plenty	plenty
plus	plus
pocket	pocket
point	point
pointed	pointed
poor	poor
poorly	poorly
pop	pop
post	post
potential	potential
power	power
powerful	powerful
precise	precise
prefer	prefer
pressing	pressing
pretty	pretty
price	price
priced	priced
prints	prints
pro	pro
probably	probably
problem	problem
problems	problems
product	product
products	products
properly	properly
pros	pros
protect	protect
protection	protection
provided	provided
provides	provides
pulled	pulled
purchased	purchased
purchasing	purchasing
purposes	purposes
put	put
quality	quality
quick	quick
quickly	quickly
quit	quit
quite	quite
range	range
re	re
reach	reach
really	really
reasonably	reasonably
received	received
recognize	recognize
recommend	recommend
recommended	recommended
recording	recording
refund	refund
regular	regular
remote	remote
repeat	repeat
repeatedly	repeatedly
replace	replace
replacement	replacement
resolution	resolution
resolve	resolve
rest	rest
return	return
returned	returned
returning	returning
reviews	reviews
ridiculous	ridiculous
right	right
rip	rip
ripped	ripped
road	road
rock	rock
room	room
rooms	rooms
s	s
sad	sad
sadly	sadly
said	said
sale	sale
same	same
satisfied	satisfied
save	save
saved	saved
savvy	savvy
say	say
saying	saying
says	says
school	school
scratching	scratching
screen	screen
second	second
see	see
seemed	seemed
seen	seen
sell	sell
send	send
sending	sending
sent	sent
separate	separate
service	service
several	several
shame	shame
ship	ship
short	short
should	should
shows	shows
shut	shut
side	side
sign	sign
simple	simple
site	site
sitting	sitting
situation	situation
size	size
sized	sized
sleek	sleek
slightest	slightest
slightly	slightly
slim	slim
small	small
smart	smart
so	so
solid	solid
solved	solved
some	some
someone	someone
something	something
sometimes	sometimes
sound	sound
sounds	sounds
source	source
space	space
spare	spare
speaker	speaker
speakers	speakers
speaking	speaking
special	special
specific	specific
spoke	spoke
stand	stand
star	star
stars	stars
started	started
stated	stated
static	static
station	station
stay	stay
stayed	stayed
stereo	stereo
stick	stick
still	still
stop	stop
stopped	stopped
stops	stops
store	store
stores	stores
strange	strange
strap	strap
stuck	stuck
studio	studio
sub	sub
such	such
suck	suck
sucks	sucks
sudden	sudden
super	super
superb	superb
support	support
supports	supports
supposed	supposed
sure	sure
surprised	surprised
surprisingly	surprisingly
surround	surround
switched	switched
system	system
t	t
tag	tag
take	take
takes	takes
taking	taking
tape	tape
tax	tax
tech	tech
techno	techno
tell	tell
terms	terms
terrible	terrible
terribly	terribly
than	than
that	that
the	the
theater	theater
their	their
them	them
then	then
there	there
these	these
they	they
thick	thick
thing	thing
things	things
think	think
this	this
those	those
thought	thought
throw	throw
thru	thru
time	time
times	times
to	to
today	today
told	told
too	too
took	took
top	top
total	total
touch	touch
transfer	transfer
trash	trash
traveling	traveling
travels	travels
tricky	tricky
tried	tried
try	try
trying	trying
tunes	tunes
turn	turn
turned	turned
tv	tv
two	two
unable	unable
uncomfortable	uncomfortable
unfortunately	unfortunately
until	until
up	up
updated	updated
use	use
used	used
useful	useful
useless	useless
users	users
using	using
value	value
ve	ve
very	very
video	video
vivid	vivid
vs	vs
waiting	waiting
walls	walls
wanted	wanted
warned	warned
was	was
wasn	wasn
waste	waste
wasted	wasted
way	way
we	we
weak	weak
wear	wear
week	week
weeks	weeks
weight	weight
well	well
went	went
were	were
what	what
when	when
whenever	whenever
where	where
which	which
white	white
who	who
whole	whole
wide	wide
will	will
wires	wires
wish	wish
with	with
within	within
without	without
won	won
wonderful	wonderful
words	words
work	work
worked	worked
working	working
works	works
world	world
worried	worried
worry	worry
worse	worse
worst	worst
worth	worth
worthless	worthless
would	would
wouldn	wouldn
wow	wow
wrong	wrong
wrote	wrote
x	x
yeah	yeah
year	year
years	years
yesterday	yesterday
yet	yet
you	you
your	your
zoom	zoom
