0	0
1	1
10	10
11	11
18	18
2	2
20	20
200	200
2004	2004
3	3
4	4
5	5
50	50
6	6
90	90
a	a
ability	ability
able	able
about	about
absolutely	absolutely
according	according
actually	actually
add	add
addition	addition
additional	additional
address	address
advice	advice
advise	advise
after	after
again	again
ago	ago
ahead	ahead
aid	aid
all	all
allowed	allowed
allows	allows
almost	almost
alone	alone
also	also
always	always
am	am
amazing	amazing
amazon	amazon
an	an
and	and
another	another
any	any
anymore	anymore
anyone	anyone
anything	anything
apart	apart
apparently	apparently
appeared	appeared
appreciate	appreciate
are	are
aren	aren
as	as
aside	aside
at	at
attached	attached
attempt	attempt
avoid	avoid
away	away
awesome	awesome
awful	awful
awkward	awkward
baby	baby
back	back
bad	bad
badly	badly
balance	balance
barely	barely
bargain	bargain
base	base
based	based
batch	batch
be	be
beach	beach
beat	beat
beats	beats
beautiful	beautiful
beautifully	beautifully
became	became
because	because
bedroom	bedroom
been	been
before	before
being	being
believe	believe
best	best
better	better
between	between
beware	beware
bigger	bigger
biggest	biggest
bit	bit
blue	blue
both	both
bottom	bottom
bought	bought
bowl	bowl
box	box
brand	brand
breaks	breaks
broke	broke
broken	broken
brown	brown
burned	burned
burns	burns
business	business
but	but
butter	butter
buy	buy
buyer	buyer
buying	buying
by	by
call	call
called	called
calls	calls
came	came
can	can
cannot	cannot
careful	careful
cast	cast
caused	caused
causing	causing
changed	changed
cheap	cheap
check	check
checking	checking
china	china
chops	chops
classy	classy
clean	clean
clear	clear
close	close
closed	closed
collecting	collecting
collection	collection
colors	colors
com	com
come	come
comes	comes
comfortable	comfortable
common	common
company	company
compared	compared
complaint	complaint
complaints	complaints
concept	concept
concerned	concerned
condition	condition
considering	considering
construction	construction
contacted	contacted
contemporary	contemporary
continued	continued
continues	continues
convenient	convenient
cook	cook
cooking	cooking
corn	corn
correctly	correctly
cost	cost
could	could
count	count
covered	covered
crack	crack
cracked	cracked
cracks	cracks
crap	crap
creating	creating
credit	credit
crushing	crushing
curve	curve
customer	customer
cuts	cuts
cycle	cycle
d	d
dangerous	dangerous
day	day
days	days
dead	dead
deal	deal
decided	decided
defect	defect
defective	defective
definately	definately
definitely	definitely
degree	degree
degrees	degrees
delicious	delicious
department	department
description	description
design	design
desk	desk
despite	despite
developed	developed
did	did
didn	didn
died	died
different	different
difficult	difficult
digital	digital
dinner	dinner
disappointed	disappointed
disappointing	disappointing
disappointment	disappointment
discovered	discovered
dishes	dishes
dissapointed	dissapointed
do	do
does	does
doesn	doesn
don	don
done	done
double	double
doubt	doubt
downside	downside
drawback	drawback
during	during
dutch	dutch
duty	duty
e	e
ease	ease
easier	easier
easily	easily
easy	easy
eat	eat
edge	edge
efficient	efficient
eight	eight
either	either
elegant	elegant
else	else
elsewhere	elsewhere
end	end
ended	ended
ends	ends
enjoy	enjoy
enjoyed	enjoyed
enjoying	enjoying
enough	enough
especially	especially
essential	essential
even	even
ever	ever
every	every
everything	everything
everywhere	everywhere
exactly	exactly
excellent	excellent
excited	excited
expect	expect
experience	experience
experienced	experienced
extra	extra
extreme	extreme
fabulous	fabulous
fact	fact
failed	failed
fails	fails
failure	failure
family	family
fan	fan
fantastic	fantastic
far	far
fault	fault
faulty	faulty
favor	favor
favorite	favorite
feature	feature
feel	feel
feeling	feeling
feet	feet
fell	fell
felt	felt
few	few
figured	figured
finally	finally
find	find
fine	fine
finger	finger
first	first
fit	fit
fits	fits
fix	fix
fixed	fixed
flaw	flaw
flow	flow
followed	followed
food	food
for	for
found	found
fragile	fragile
free	free
french	french
friends	friends
from	from
front	front
full	full
funny	funny
further	further
future	future
garage	garage
garbage	garbage
gave	gave
gently	gently
get	get
gets	gets
gifts	gifts
give	give
given	given
gives	gives
glad	glad
go	go
goes	goes
going	going
gold	gold
good	good
got	got
great	great
grounds	grounds
guess	guess
guests	guests
had	had
half	half
hamilton	hamilton
hand	hand
handle	handle
handles	handles
handy	handy
happy	happy
hard	hard
hardly	hardly
has	has
have	have
haven	haven
having	having
hazard	hazard
he	he
hear	hear
heat	heat
heated	heated
heavy	heavy
help	help
helps	helps
here	here
high	high
highest	highest
highly	highly
his	his
hold	hold
holds	holds
holidays	holidays
home	home
hope	hope
hopes	hopes
hoping	hoping
horrible	horrible
house	house
how	how
huge	huge
husband	husband
i	i
ice	ice
idea	idea
ideal	ideal
if	if
image	image
imagine	imagine
impossible	impossible
impressed	impressed
in	in
included	included
individual	individual
inferior	inferior
information	information
ingredients	ingredients
inside	inside
instead	instead
instructions	instructions
intend	intend
into	into
iron	iron
is	is
issues	issues
it	it
item	item
its	its
itself	itself
job	job
jobs	jobs
joke	joke
junk	junk
just	just
keeps	keeps
kept	kept
key	key
kind	kind
kitchen	kitchen
knew	knew
knife	knife
know	know
lack	lack
large	large
larger	larger
last	last
lasted	lasted
later	later
leave	leave
leaving	leaving
left	left
less	less
let	let
letting	letting
life	life
lifetime	lifetime
lighter	lighter
lightweight	lightweight
like	like
liked	liked
likely	likely
lines	lines
literally	literally
little	little
live	live
ll	ll
local	local
long	long
longer	longer
look	look
looked	looked
looking	looking
looks	looks
love	love
loved	loved
lovely	lovely
loves	loves
luck	luck
lucky	lucky
m	m
machine	machine
mad	mad
made	made
make	make
makes	makes
making	making
manual	manual
many	many
market	market
matter	matter
may	may
maybe	maybe
me	me
meat	meat
medium	medium
meet	meet
mess	mess
metal	metal
middle	middle
mill	mill
minutes	minutes
mistake	mistake
mixed	mixed
mixes	mixes
money	money
month	month
months	months
more	more
most	most
much	much
must	must
my	my
near	near
necessary	necessary
neck	neck
need	need
needed	needed
needs	needs
neither	neither
never	never
new	new
next	next
nice	nice
nicely	nicely
night	night
no	no
normally	normally
not	not
notch	notch
note	note
noticed	noticed
now	now
number	number
of	of
off	off
office	office
often	often
ok	ok
old	old
older	older
on	on
one	one
only	only
onto	onto
opened	opened
or	or
ordered	ordered
other	other
ours	ours
out	out
outstanding	outstanding
over	over
overall	overall
own	own
owned	owned
oz	oz
package	package
packing	packing
pad	pad
pain	pain
pans	pans
part	part
parts	parts
pass	pass
past	past
pattern	pattern
pay	pay
penny	penny
perfect	perfect
perfectly	perfectly
person	person
pie	pie
piece	piece
placed	placed
places	places
plastic	plastic
pleased	pleased
plenty	plenty
poor	poor
poorly	poorly
pounds	pounds
powerful	powerful
practical	practical
prefer	prefer
prepared	prepared
pretty	pretty
previous	previous
price	price
priced	priced
prior	prior
problem	problem
problems	problems
process	process
produce	produce
product	product
products	products
proof	proof
properly	properly
pull	pull
pulled	pulled
purchase	purchase
purchased	purchased
purchasing	purchasing
put	put
quality	quality
queen	queen
quick	quick
quickly	quickly
quiet	quiet
quit	quit
re	re
read	read
really	really
reasonably	reasonably
receive	receive
received	received
recipes	recipes
recommend	recommend
recommended	recommended
refund	refund
regret	regret
relatively	relatively
release	release
remember	remember
removing	removing
replace	replace
replacement	replacement
required	required
response	response
results	results
return	return
returned	returned
returning	returning
reviewers	reviewers
reviews	reviews
right	right
ring	ring
rival	rival
room	room
rough	rough
round	round
rounded	rounded
runs	runs
s	s
safe	safe
sale	sale
same	same
save	save
saves	saves
say	say
scratching	scratching
sealed	sealed
second	second
see	see
seems	seems
seller	seller
send	send
sending	sending
sent	sent
service	service
serving	serving
set	set
sets	sets
shame	shame
sharp	sharp
she	she
ship	ship
shipping	shipping
shopping	shopping
should	should
show	show
side	side
simple	simple
simply	simply
single	single
six	six
size	size
sized	sized
slide	slide
slow	slow
smaller	smaller
smell	smell
smooth	smooth
so	so
sold	sold
solid	solid
some	some
someone	someone
something	something
sometimes	sometimes
somewhere	somewhere
son	son
soon	soon
sounded	sounded
soup	soup
space	space
special	special
speed	speed
spend	spend
spent	spent
spit	spit
star	star
stars	stars
started	started
starts	starts
stay	stay
steam	steam
stick	stick
still	still
stir	stir
stop	stop
stopped	stopped
storage	storage
stores	stores
strong	strong
stuck	stuck
stupid	stupid
stylish	stylish
such	such
sucks	sucks
super	super
supposed	supposed
sure	sure
surface	surface
t	t
table	table
take	take
tank	tank
target	target
tastes	tastes
taylor	taylor
tea	tea
tell	tell
terrible	terrible
than	than
thanksgiving	thanksgiving
that	that
the	the
their	their
them	them
then	then
there	there
therefore	therefore
these	these
they	they
thin	thin
thing	thing
think	think
thinking	thinking
this	this
those	those
thought	thought
three	three
threw	threw
through	through
throwing	throwing
thus	thus
time	time
times	times
tips	tips
to	to
told	told
tomorrow	tomorrow
too	too
took	took
tool	tool
tools	tools
total	total
touch	touch
tried	tried
trigger	trigger
try	try
trying	trying
turn	turn
turned	turned
twice	twice
two	two
typical	typical
uncomfortable	uncomfortable
unfortunately	unfortunately
unhappy	unhappy
unique	unique
unit	unit
until	until
unusual	unusual
up	up
upon	upon
upset	upset
usa	usa
use	use
used	used
useful	useful
useless	useless
using	using
value	value
ve	ve
versatile	versatile
versions	versions
very	very
vin	vin
wait	wait
waited	waited
waiting	waiting
walk	walk
want	want
warning	warning
warped	warped
was	was
washed	washed
waste	waste
water	water
way	way
we	we
weak	weak
wedding	wedding
weeks	weeks
weight	weight
well	well
went	went
were	were
what	what
when	when
where	where
which	which
while	while
whip	whip
who	who
why	why
will	will
winner	winner
wires	wires
wish	wish
with	with
within	within
won	won
wonderful	wonderful
wooden	wooden
word	word
work	work
worked	worked
working	working
works	works
worry	worry
worse	worse
worst	worst
worth	worth
worthless	worthless
would	would
written	written
wrong	wrong
year	year
years	years
yesterday	yesterday
you	you
your	your
zero	zero
