0	0
1	1
10	10
18	18
2	2
20	20
200	200
2005	2005
2006	2006
3	3
4	4
5	5
6	6
7	7
90	90
a	a
ability	ability
about	about
absolutely	absolutely
acceptable	acceptable
accessories	accessories
actually	actually
add	add
added	added
addition	addition
additionally	additionally
adequate	adequate
advice	advice
advise	advise
affordable	affordable
after	after
again	again
ahead	ahead
all	all
allowed	allowed
allows	allows
almost	almost
also	also
alternative	alternative
always	always
am	am
amazed	amazed
amazing	amazing
amazon	amazon
an	an
and	and
another	another
any	any
anyone	anyone
anything	anything
apart	apart
appeared	appeared
are	are
as	as
aside	aside
at	at
attached	attached
attempt	attempt
avoid	avoid
away	away
awesome	awesome
awful	awful
baby	baby
back	back
bad	bad
badly	badly
bag	bag
balance	balance
barely	barely
base	base
based	based
basic	basic
batteries	batteries
be	be
beat	beat
beats	beats
beautiful	beautiful
beautifully	beautifully
became	became
because	because
been	been
before	before
began	began
being	being
best	best
better	better
between	between
beware	beware
big	big
bigger	bigger
bit	bit
black	black
book	book
bottom	bottom
bought	bought
box	box
brand	brand
brands	brands
break	break
breeze	breeze
broke	broke
broken	broken
burned	burned
burns	burns
business	business
but	but
buy	buy
buyer	buyer
buying	buying
by	by
call	call
called	called
came	came
can	can
carefully	carefully
caused	caused
causing	causing
certain	certain
changed	changed
cheap	cheap
cheaply	cheaply
check	check
checked	checked
choice	choice
clean	clean
clearly	clearly
clock	clock
closed	closed
collection	collection
color	color
colors	colors
com	com
come	come
comes	comes
comfortable	comfortable
company	company
compared	compared
complaint	complaint
complaints	complaints
completely	completely
concerned	concerned
condition	condition
consumer	consumer
contact	contact
contacted	contacted
continues	continues
control	control
convenient	convenient
correct	correct
correctly	correctly
cost	cost
could	could
covered	covered
crack	crack
crap	crap
credit	credit
cups	cups
curve	curve
customer	customer
cuts	cuts
cycle	cycle
day	day
days	days
dead	dead
deal	deal
defect	defect
defective	defective
definately	definately
definitely	definitely
degree	degree
degrees	degrees
deliver	deliver
delivered	delivered
department	department
description	description
design	design
designed	designed
developed	developed
did	did
didn	didn
died	died
different	different
difficult	difficult
dirty	dirty
disappointed	disappointed
disappointing	disappointing
disappointment	disappointment
discovered	discovered
dissapointed	dissapointed
do	do
does	does
doesn	doesn
don	don
done	done
dont	dont
double	double
doubt	doubt
downside	downside
drawer	drawer
durable	durable
during	during
duty	duty
e	e
ease	ease
easier	easier
easy	easy
edge	edge
efficient	efficient
either	either
elegant	elegant
elements	elements
else	else
elsewhere	elsewhere
email	email
emailed	emailed
end	end
ended	ended
ends	ends
enjoy	enjoy
enjoyed	enjoyed
enough	enough
especially	especially
essential	essential
even	even
ever	ever
every	every
everyday	everyday
everyone	everyone
everything	everything
everywhere	everywhere
exactly	exactly
excellent	excellent
excited	excited
experience	experience
experienced	experienced
extra	extra
extreme	extreme
fabulous	fabulous
fact	fact
fail	fail
failed	failed
failure	failure
fairly	fairly
family	family
fantastic	fantastic
far	far
fault	fault
faulty	faulty
favorite	favorite
feature	feature
feeling	feeling
feet	feet
felt	felt
few	few
fill	fill
finally	finally
find	find
fine	fine
finger	finger
first	first
fit	fit
fits	fits
fix	fix
flexible	flexible
flimsy	flimsy
flow	flow
followed	followed
for	for
force	force
found	found
fragile	fragile
friend	friend
friends	friends
from	from
front	front
full	full
funny	funny
further	further
garbage	garbage
gave	gave
gear	gear
get	get
gifts	gifts
glad	glad
glasses	glasses
go	go
going	going
gone	gone
good	good
got	got
great	great
guess	guess
had	had
half	half
handles	handles
handy	handy
hang	hang
happier	happier
happy	happy
hard	hard
has	has
have	have
haven	haven
having	having
hear	hear
heard	heard
heat	heat
heavy	heavy
help	help
here	here
high	high
highest	highest
highly	highly
him	him
his	his
hit	hit
hold	hold
holds	holds
hopefully	hopefully
hoping	hoping
horrible	horrible
house	house
how	how
huge	huge
husband	husband
i	i
idea	idea
ideal	ideal
if	if
image	image
impossible	impossible
impressed	impressed
in	in
included	included
incredibly	incredibly
indeed	indeed
individual	individual
inferior	inferior
information	information
instead	instead
intend	intend
internet	internet
is	is
issues	issues
it	it
item	item
its	its
job	job
junk	junk
just	just
keeps	keeps
kept	kept
kitchen	kitchen
knew	knew
lack	lack
large	large
larger	larger
last	last
lasted	lasted
later	later
leave	leave
leaving	leaving
left	left
length	length
less	less
letting	letting
light	light
lighter	lighter
like	like
liked	liked
little	little
lived	lived
ll	ll
local	local
lock	lock
long	long
longer	longer
look	look
looked	looked
looks	looks
loose	loose
love	love
loved	loved
loves	loves
lowest	lowest
luck	luck
lucky	lucky
m	m
machine	machine
mad	mad
made	made
make	make
makes	makes
manual	manual
manually	manually
manufacture	manufacture
market	market
material	material
matter	matter
may	may
maybe	maybe
me	me
mean	mean
mechanism	mechanism
medium	medium
mess	mess
metal	metal
mind	mind
mine	mine
minutes	minutes
mistake	mistake
mixed	mixed
model	model
money	money
month	month
months	months
more	more
most	most
much	much
multi	multi
must	must
my	my
myself	myself
name	name
necessary	necessary
need	need
needed	needed
needs	needs
neither	neither
never	never
new	new
newer	newer
next	next
nice	nice
nicely	nicely
no	no
noisy	noisy
normally	normally
not	not
notch	notch
nothing	nothing
noticed	noticed
now	now
of	of
off	off
office	office
oh	oh
ok	ok
old	old
older	older
on	on
once	once
one	one
ones	ones
only	only
or	or
order	order
ordered	ordered
other	other
out	out
outstanding	outstanding
over	over
overall	overall
owned	owned
owning	owning
package	package
packing	packing
pad	pad
pain	pain
paint	paint
parts	parts
pass	pass
past	past
pay	pay
penny	penny
perfect	perfect
perfectly	perfectly
performance	performance
person	person
phone	phone
piece	piece
places	places
plastic	plastic
pleased	pleased
plenty	plenty
plugged	plugged
poor	poor
poorly	poorly
possibly	possibly
post	post
powerful	powerful
practical	practical
prefer	prefer
premium	premium
prepared	prepared
previous	previous
price	price
prices	prices
prior	prior
problem	problem
problems	problems
process	process
product	product
products	products
properly	properly
protect	protect
pull	pull
pulled	pulled
purchase	purchase
purchased	purchased
purchasing	purchasing
put	put
quality	quality
quick	quick
quickly	quickly
quiet	quiet
quit	quit
read	read
reading	reading
really	really
reason	reason
reasonably	reasonably
reasons	reasons
receipt	receipt
received	received
recommend	recommend
recommended	recommended
refund	refund
refused	refused
release	release
remember	remember
repair	repair
replace	replace
replacement	replacement
required	required
resistant	resistant
response	response
results	results
return	return
returned	returned
returning	returning
review	review
reviews	reviews
right	right
ring	ring
room	room
rough	rough
round	round
rounded	rounded
run	run
s	s
safe	safe
sale	sale
same	same
save	save
saver	saver
saves	saves
saw	saw
say	say
saying	saying
says	says
scratching	scratching
second	second
seconds	seconds
see	see
seems	seems
seen	seen
seller	seller
send	send
sending	sending
sent	sent
service	service
set	set
sets	sets
several	several
shame	shame
shape	shape
sharp	sharp
she	she
sheets	sheets
ship	ship
shipped	shipped
shop	shop
should	should
shouldn	shouldn
shut	shut
simple	simple
single	single
site	site
size	size
sized	sized
sizes	sizes
slow	slow
small	small
smooth	smooth
snap	snap
so	so
soft	soft
sold	sold
solved	solved
some	some
someone	someone
something	something
sometimes	sometimes
somewhere	somewhere
son	son
soon	soon
sorts	sorts
sounded	sounded
space	space
special	special
spent	spent
stand	stand
star	star
started	started
starts	starts
stay	stay
stick	stick
still	still
stop	stop
stopped	stopped
storage	storage
store	store
stores	stores
strong	strong
stuck	stuck
sturdy	sturdy
sucks	sucks
super	super
superb	superb
supposed	supposed
sure	sure
suspect	suspect
switch	switch
t	t
take	take
takes	takes
taking	taking
talk	talk
tank	tank
target	target
tasks	tasks
taste	taste
tell	tell
terrible	terrible
terrific	terrific
than	than
thanks	thanks
that	that
the	the
their	their
them	them
themselves	themselves
then	then
there	there
these	these
they	they
thicker	thicker
thin	thin
thing	thing
things	things
think	think
thinking	thinking
this	this
those	those
though	though
thought	thought
three	three
threw	threw
thrilled	thrilled
through	through
time	time
times	times
tips	tips
to	to
told	told
tomorrow	tomorrow
too	too
took	took
tool	tool
total	total
tried	tried
try	try
trying	trying
turn	turn
twice	twice
two	two
uncomfortable	uncomfortable
under	under
unfortunately	unfortunately
unique	unique
unit	unit
units	units
unlike	unlike
until	until
unusable	unusable
up	up
upset	upset
use	use
used	used
useful	useful
useless	useless
using	using
value	value
ve	ve
versatile	versatile
versions	versions
very	very
waiting	waiting
want	want
wanted	wanted
warning	warning
warranty	warranty
was	was
waste	waste
way	way
we	we
weak	weak
wearing	wearing
website	website
week	week
weeks	weeks
weight	weight
well	well
went	went
were	were
what	what
when	when
where	where
while	while
who	who
why	why
will	will
wires	wires
wish	wish
with	with
within	within
won	won
wonderful	wonderful
wonderfully	wonderfully
work	work
worked	worked
working	working
works	works
worry	worry
worse	worse
worst	worst
worth	worth
would	would
wouldn	wouldn
wrong	wrong
wrote	wrote
year	year
years	years
yet	yet
you	you
your	your
zero	zero
