2	2
3	3
90	90
a	a
ability	ability
absolutely	absolutely
add	add
added	added
addition	addition
address	address
advice	advice
after	after
again	again
all	all
amazing	amazing
amazon	amazon
an	an
and	and
any	any
apart	apart
appeared	appeared
appreciate	appreciate
are	are
aren	aren
around	around
as	as
at	at
attempt	attempt
awesome	awesome
awful	awful
baby	baby
back	back
bad	bad
badly	badly
balance	balance
barely	barely
base	base
based	based
be	be
beat	beat
beautiful	beautiful
beautifully	beautifully
being	being
best	best
better	better
beware	beware
bit	bit
blue	blue
bought	bought
broke	broke
broken	broken
building	building
business	business
but	but
buy	buy
by	by
call	call
called	called
can	can
cannot	cannot
catch	catch
caused	caused
cheap	cheap
clean	clean
collection	collection
comes	comes
comfortable	comfortable
company	company
compared	compared
condition	condition
cooking	cooking
could	could
customer	customer
cycle	cycle
dangerous	dangerous
dead	dead
decided	decided
delicious	delicious
did	did
didn	didn
died	died
difficult	difficult
disappointed	disappointed
disappointing	disappointing
disappointment	disappointment
dishes	dishes
do	do
does	does
don	don
double	double
ease	ease
easy	easy
efficient	efficient
elegant	elegant
else	else
end	end
ended	ended
enjoy	enjoy
enjoying	enjoying
enough	enough
essential	essential
even	even
ever	ever
every	every
everyday	everyday
everywhere	everywhere
excellent	excellent
excited	excited
experience	experience
fabulous	fabulous
fact	fact
failed	failed
failure	failure
family	family
fantastic	fantastic
far	far
faster	faster
favorite	favorite
feeling	feeling
feet	feet
first	first
fits	fits
fix	fix
followed	followed
foods	foods
for	for
friends	friends
from	from
funny	funny
get	get
gives	gives
go	go
going	going
gold	gold
good	good
great	great
guess	guess
had	had
half	half
handy	handy
hard	hard
has	has
have	have
haven	haven
he	he
heard	heard
heavy	heavy
highly	highly
his	his
holds	holds
horrible	horrible
how	how
huge	huge
i	i
idea	idea
impossible	impossible
impressed	impressed
in	in
incredibly	incredibly
information	information
instead	instead
internet	internet
is	is
it	it
its	its
job	job
junk	junk
just	just
keeps	keeps
kind	kind
kitchen	kitchen
know	know
large	large
larger	larger
leaving	leaving
less	less
like	like
little	little
long	long
love	love
loved	loved
loves	loves
lucky	lucky
machine	machine
made	made
main	main
makes	makes
may	may
me	me
mess	mess
mistake	mistake
money	money
month	month
months	months
more	more
most	most
much	much
multi	multi
must	must
my	my
need	need
never	never
new	new
nice	nice
nicely	nicely
no	no
none	none
not	not
noticed	noticed
now	now
of	of
off	off
older	older
on	on
one	one
only	only
or	or
ordered	ordered
other	other
out	out
outstanding	outstanding
over	over
overall	overall
pain	pain
past	past
pay	pay
perfect	perfect
perfectly	perfectly
person	person
piece	piece
plain	plain
pleased	pleased
plenty	plenty
poor	poor
poorly	poorly
post	post
powerful	powerful
price	price
problem	problem
production	production
properly	properly
pulled	pulled
purchasing	purchasing
quick	quick
quickly	quickly
quiet	quiet
quit	quit
read	read
reason	reason
receive	receive
received	received
recommend	recommend
recommended	recommended
remember	remember
return	return
returned	returned
returning	returning
reviews	reviews
ring	ring
rough	rough
round	round
run	run
s	s
sale	sale
same	same
save	save
second	second
seems	seems
seen	seen
send	send
sent	sent
service	service
serving	serving
set	set
shame	shame
sharp	sharp
shelf	shelf
should	should
simple	simple
size	size
so	so
solid	solid
some	some
someone	someone
somewhere	somewhere
soon	soon
space	space
special	special
star	star
started	started
stopped	stopped
stores	stores
superb	superb
sure	sure
t	t
table	table
tell	tell
terrible	terrible
than	than
that	that
the	the
then	then
there	there
think	think
this	this
thought	thought
time	time
times	times
to	to
told	told
too	too
took	took
tool	tool
tried	tried
try	try
type	type
unfortunately	unfortunately
unique	unique
unit	unit
until	until
up	up
use	use
used	used
useful	useful
useless	useless
value	value
ve	ve
very	very
vs	vs
waiting	waiting
want	want
was	was
waste	waste
we	we
weak	weak
weeks	weeks
well	well
went	went
what	what
when	when
where	where
while	while
who	who
why	why
will	will
winner	winner
wish	wish
with	with
wonderful	wonderful
wonderfully	wonderfully
work	work
worked	worked
working	working
works	works
worry	worry
worse	worse
worst	worst
worth	worth
would	would
wrong	wrong
you	you
your	your
