1	1
10	10
150	150
2	2
20	20
2006	2006
3	3
4	4
5	5
6	6
90	90
a	a
ability	ability
able	able
about	about
absolutely	absolutely
actual	actual
actually	actually
add	add
added	added
addition	addition
additional	additional
additionally	additionally
advantage	advantage
advice	advice
affordable	affordable
after	after
again	again
agree	agree
aid	aid
all	all
allowed	allowed
allows	allows
almost	almost
also	also
aluminum	aluminum
always	always
am	am
amazed	amazed
amazing	amazing
amazon	amazon
an	an
and	and
another	another
any	any
anything	anything
apart	apart
apartment	apartment
appeared	appeared
appreciate	appreciate
are	are
around	around
arrived	arrived
as	as
aside	aside
at	at
attached	attached
attachments	attachments
attempt	attempt
attractive	attractive
automatic	automatic
available	available
avoid	avoid
away	away
awesome	awesome
awful	awful
baby	baby
back	back
bad	bad
badly	badly
bag	bag
bake	bake
baker	baker
balance	balance
balanced	balanced
barely	barely
bark	bark
barking	barking
base	base
based	based
basic	basic
be	be
beat	beat
beats	beats
beautiful	beautiful
beautifully	beautifully
beauty	beauty
because	because
bedroom	bedroom
been	been
before	before
began	began
being	being
believe	believe
best	best
better	better
between	between
beware	beware
bit	bit
black	black
blade	blade
blender	blender
blue	blue
bodum	bodum
both	both
bottom	bottom
bought	bought
bowl	bowl
box	box
brand	brand
brands	brands
bread	bread
break	break
breeze	breeze
bring	bring
brittle	brittle
broke	broke
broken	broken
brushes	brushes
building	building
burn	burn
burned	burned
burns	burns
burst	burst
business	business
but	but
butter	butter
buy	buy
buyer	buyer
buying	buying
by	by
cake	cake
call	call
called	called
calls	calls
came	came
can	can
cannot	cannot
carefully	carefully
cast	cast
caused	caused
causing	causing
charge	charge
cheap	cheap
cheaply	cheaply
check	check
chickens	chickens
chops	chops
class	class
classy	classy
clean	clean
cleaning	cleaning
cleans	cleans
closed	closed
coated	coated
coffee	coffee
collection	collection
colors	colors
come	come
comes	comes
comfortable	comfortable
coming	coming
common	common
company	company
compared	compared
complaining	complaining
complaint	complaint
complaints	complaints
concept	concept
concerned	concerned
condition	condition
construction	construction
contact	contact
contacted	contacted
container	container
contemporary	contemporary
contents	contents
convenient	convenient
cook	cook
cookie	cookie
cookies	cookies
cooking	cooking
cooks	cooks
cookware	cookware
cool	cool
cooling	cooling
copper	copper
corn	corn
corner	corner
corningware	corningware
correctly	correctly
could	could
couldn	couldn
counter	counter
cover	cover
cracked	cracked
crap	crap
crazy	crazy
creating	creating
credit	credit
creuset	creuset
crush	crush
cuisinart	cuisinart
cupboard	cupboard
customer	customer
cuts	cuts
cycle	cycle
dangerous	dangerous
day	day
days	days
dead	dead
deal	deal
decided	decided
defect	defect
defective	defective
definitely	definitely
degrees	degrees
delicious	delicious
delivered	delivered
delonghi	delonghi
design	design
designed	designed
desk	desk
developed	developed
diameter	diameter
did	did
didn	didn
died	died
difference	difference
different	different
difficult	difficult
digital	digital
dinnerware	dinnerware
disappointed	disappointed
disappointing	disappointing
disappointment	disappointment
discovered	discovered
dishes	dishes
dishwasher	dishwasher
dissapointed	dissapointed
distribution	distribution
do	do
does	does
doesn	doesn
don	don
done	done
double	double
doubt	doubt
drawback	drawback
drawer	drawer
durable	durable
during	during
dutch	dutch
duty	duty
e	e
ease	ease
easier	easier
easily	easily
easy	easy
eat	eat
eating	eating
edge	edge
efficient	efficient
either	either
elegant	elegant
elements	elements
else	else
email	email
emailed	emailed
end	end
ended	ended
ends	ends
enjoy	enjoy
enough	enough
especially	especially
essential	essential
etc	etc
even	even
evenly	evenly
ever	ever
every	every
everyday	everyday
everyone	everyone
everything	everything
everywhere	everywhere
exactly	exactly
excellent	excellent
excited	excited
expect	expect
expecting	expecting
expensive	expensive
experience	experience
extra	extra
fabulous	fabulous
fact	fact
failed	failed
failure	failure
fairly	fairly
fal	fal
family	family
fantastic	fantastic
far	far
fashioned	fashioned
favor	favor
favorite	favorite
feature	feature
feeling	feeling
few	few
fiestaware	fiestaware
finally	finally
find	find
fine	fine
finger	finger
first	first
fit	fit
fits	fits
fix	fix
fixed	fixed
flimsy	flimsy
flow	flow
followed	followed
food	food
foods	foods
for	for
force	force
forget	forget
found	found
fragile	fragile
french	french
friends	friends
from	from
front	front
fruits	fruits
function	function
funny	funny
garbage	garbage
gave	gave
gear	gear
gears	gears
gently	gently
get	get
gets	gets
gift	gift
give	give
given	given
glad	glad
go	go
going	going
good	good
gorgeous	gorgeous
got	got
great	great
griddle	griddle
grills	grills
grind	grind
grip	grip
grounds	grounds
guess	guess
guests	guests
had	had
half	half
hand	hand
handle	handle
handles	handles
hands	hands
handy	handy
hang	hang
happier	happier
happy	happy
hard	hard
harder	harder
has	has
have	have
haven	haven
having	having
he	he
head	head
healthier	healthier
hear	hear
heard	heard
hearing	hearing
heat	heat
heating	heating
heats	heats
heavy	heavy
helps	helps
here	here
high	high
highly	highly
his	his
hit	hit
hold	hold
holds	holds
holidays	holidays
home	home
homemade	homemade
hoover	hoover
hope	hope
horrible	horrible
hot	hot
how	how
huge	huge
i	i
ice	ice
idea	idea
ideal	ideal
if	if
image	image
imagine	imagine
immediately	immediately
impossible	impossible
impressed	impressed
in	in
inches	inches
included	included
individual	individual
information	information
inside	inside
instead	instead
instructions	instructions
into	into
iron	iron
is	is
isn	isn
issues	issues
it	it
item	item
its	its
japanese	japanese
job	job
joke	joke
junk	junk
just	just
keep	keep
keeps	keeps
kept	kept
kettles	kettles
kind	kind
king	king
kitchen	kitchen
kitchenaid	kitchenaid
knew	knew
knife	knife
knives	knives
know	know
krups	krups
lack	lack
large	large
larger	larger
last	last
lasted	lasted
later	later
le	le
leak	leak
leaked	leaked
leaks	leaks
leaving	leaving
left	left
length	length
less	less
let	let
level	level
lifetime	lifetime
light	light
lightweight	lightweight
like	like
liked	liked
line	line
lint	lint
listed	listed
literally	literally
litter	litter
little	little
lived	lived
lives	lives
ll	ll
loaves	loaves
lodge	lodge
long	long
longer	longer
look	look
looked	looked
looking	looking
lots	lots
love	love
loved	loved
lovely	lovely
loves	loves
lowest	lowest
lucky	lucky
m	m
machine	machine
made	made
mail	mail
main	main
make	make
maker	maker
makes	makes
making	making
manufacture	manufacture
many	many
matter	matter
may	may
maybe	maybe
me	me
mean	mean
measuring	measuring
mechanism	mechanism
medium	medium
melt	melt
mess	mess
metal	metal
microwave	microwave
middle	middle
mine	mine
minor	minor
minute	minute
minutes	minutes
miss	miss
missed	missed
mistake	mistake
mixed	mixed
mixer	mixer
mixes	mixes
model	model
mom	mom
money	money
month	month
months	months
more	more
most	most
mostly	mostly
much	much
mug	mug
must	must
my	my
necessary	necessary
neck	neck
need	need
needed	needed
needs	needs
never	never
new	new
nice	nice
nicely	nicely
no	no
noisy	noisy
noodles	noodles
nor	nor
normally	normally
not	not
note	note
nothing	nothing
noticed	noticed
now	now
of	of
off	off
office	office
often	often
oh	oh
ok	ok
old	old
older	older
olive	olive
on	on
one	one
onion	onion
only	only
opened	opened
or	or
ordered	ordered
other	other
others	others
out	out
outstanding	outstanding
oval	oval
oven	oven
over	over
overall	overall
overpriced	overpriced
owned	owned
oxo	oxo
package	package
packaging	packaging
packing	packing
pad	pad
paid	paid
pain	pain
pan	pan
pancakes	pancakes
pans	pans
particular	particular
parts	parts
pass	pass
past	past
pasta	pasta
pay	pay
penny	penny
perfect	perfect
perfectly	perfectly
person	person
pet	pet
piece	piece
pieces	pieces
pillow	pillow
placed	placed
plastic	plastic
pleased	pleased
plenty	plenty
plugged	plugged
plus	plus
poor	poor
poorly	poorly
pot	pot
pounds	pounds
pour	pour
powerful	powerful
practical	practical
prefer	prefer
premium	premium
press	press
pretty	pretty
price	price
probe	probe
problem	problem
problems	problems
produce	produce
produces	produces
product	product
products	products
properly	properly
protect	protect
provides	provides
pull	pull
pulled	pulled
purchase	purchase
purchased	purchased
purchasing	purchasing
push	push
put	put
quality	quality
quick	quick
quickly	quickly
quiet	quiet
quit	quit
quite	quite
ran	ran
re	re
read	read
ready	ready
realize	realize
really	really
receipt	receipt
receive	receive
received	received
recommend	recommend
recommended	recommended
refund	refund
refurbished	refurbished
reliable	reliable
remember	remember
replace	replace
replaced	replaced
replacement	replacement
research	research
response	response
results	results
retain	retain
return	return
returned	returned
returning	returning
review	review
reviews	reviews
right	right
ring	ring
rival	rival
roasting	roasting
roasts	roasts
room	room
roomba	roomba
rough	rough
round	round
rounded	rounded
rowenta	rowenta
runs	runs
s	s
safe	safe
said	said
salad	salad
sale	sale
same	same
saucepan	saucepan
save	save
saves	saves
savings	savings
saw	saw
say	say
scratches	scratches
scratching	scratching
scrub	scrub
seasoning	seasoning
second	second
see	see
seem	seem
seems	seems
sell	sell
send	send
sending	sending
sent	sent
service	service
serving	serving
set	set
sets	sets
several	several
shame	shame
shape	shape
sharp	sharp
sheets	sheets
shelf	shelf
ship	ship
shipped	shipped
shipping	shipping
shop	shop
should	should
show	show
shut	shut
simple	simple
since	since
sink	sink
size	size
sized	sized
sizes	sizes
skillet	skillet
sleek	sleek
sleep	sleep
slicer	slicer
slide	slide
slots	slots
slow	slow
small	small
smooth	smooth
smoothie	smoothie
snap	snap
snapped	snapped
so	so
soap	soap
softer	softer
sold	sold
solid	solid
solved	solved
some	some
someone	someone
something	something
sometimes	sometimes
somewhere	somewhere
son	son
soon	soon
sooner	sooner
sorry	sorry
soup	soup
soups	soups
space	space
spatula	spatula
special	special
specifically	specifically
spend	spend
spent	spent
sponge	sponge
spoons	spoons
spout	spout
star	star
starbucks	starbucks
stars	stars
start	start
started	started
starts	starts
stay	stay
steaks	steaks
steam	steam
steel	steel
stick	stick
sticks	sticks
still	still
stir	stir
stop	stop
stopped	stopped
storage	storage
store	store
stores	stores
stove	stove
strong	strong
stuck	stuck
stuff	stuff
stupid	stupid
sturdy	sturdy
style	style
stylish	stylish
sucks	sucks
sugar	sugar
super	super
supposed	supposed
sure	sure
surface	surface
suspect	suspect
switch	switch
t	t
table	table
take	take
tall	tall
tank	tank
target	target
tasks	tasks
taste	taste
tastes	tastes
taylor	taylor
tea	tea
teflon	teflon
tell	tell
temperature	temperature
temperatures	temperatures
terrible	terrible
terrific	terrific
than	than
that	that
the	the
their	their
them	them
themselves	themselves
then	then
there	there
thermometer	thermometer
thermometers	thermometers
these	these
they	they
thicker	thicker
thin	thin
thing	thing
think	think
thinking	thinking
this	this
those	those
thought	thought
three	three
threw	threw
thrilled	thrilled
through	through
thus	thus
time	time
times	times
tips	tips
to	to
toast	toast
toaster	toaster
told	told
tomatoes	tomatoes
tomorrow	tomorrow
too	too
took	took
tool	tool
tools	tools
top	top
total	total
tried	tried
trigger	trigger
trouble	trouble
true	true
try	try
trying	trying
turn	turn
turned	turned
twice	twice
two	two
uneven	uneven
unfortunately	unfortunately
unique	unique
unit	unit
unless	unless
until	until
unusable	unusable
up	up
use	use
used	used
useful	useful
useless	useless
uses	uses
using	using
value	value
ve	ve
vegetables	vegetables
veggies	veggies
versatile	versatile
versions	versions
very	very
wait	wait
waited	waited
waiting	waiting
wall	wall
want	want
waring	waring
warning	warning
warped	warped
warranty	warranty
was	was
wash	wash
washed	washed
washes	washes
waste	waste
wasted	wasted
water	water
way	way
we	we
weak	weak
website	website
weeks	weeks
weight	weight
well	well
went	went
were	were
what	what
when	when
where	where
while	while
who	who
why	why
will	will
wires	wires
wish	wish
with	with
within	within
won	won
wonderful	wonderful
wonderfully	wonderfully
wooden	wooden
work	work
worked	worked
workhorse	workhorse
working	working
works	works
worry	worry
worse	worse
worst	worst
worth	worth
worthless	worthless
would	would
wouldn	wouldn
written	written
wrong	wrong
year	year
years	years
yesterday	yesterday
you	you
your	your
zero	zero
